The focus group represents untapped potential for furthering the quality and usefulness of child sexual abuse prevention research.	natural
The factor related to acting-out behavior did not contain the substance abuse component found in previous investigations.	natural
The groups were statistically compared on sets of external criterion variables--Addiction Severity Index measures of past and recent substance abuse and functioning and lifetime criminal history.	natural
These and other results concur with the findings of a previous investigation of infant abuse and neglect in a different primate species in indicating that neglect and abuse are different phenomena and in emphasizing genealogical influences on infant abuse in primates.	natural
Topics include: (a) demographics of individuals who participate in sadomasochistic sex; (b) the sexual characteristics of this group of individuals; (c) sexual behaviours involved and the nature of the underlying relationship of these behaviours to one another; (d) family background; and (e) experiences of childhood sexual abuse.	natural
The 10 individuals (64) with interest in witchcraft or Satanism had significantly more diagnoses of identity disorder, alcohol abuse and hallucinogen abuse.	natural
Implications for the forensic interviewing of children who allege repeated abuse are discussed.	natural
Substance abuse disorders, depressive disorders, phobias and any psychiatric disorders in young adulthood were predicted by suicidal risk in preadolescence irrespective of behavioural and emotional disorders.	natural
Thematic analysis of the focus group discussions revealed three broad themes in prosecutors' perceptions about questioning children about repeated abuse: a) permitting children to provide a full generic account before describing individual episodes of abuse, b) using the information obtained during the generic account to create episode labels, and c) probing incidences of abuse chronologically.	natural
Roughly equivalent numbers identified as gay (40.6 ) and bisexual (41.3 ), while fewer identified as straight (7.6 ) or down low (10.5 ), with significant differences in age, income, history of incarceration, HIV status, alcohol and drug problems, childhood sexual abuse, and connection to the gay community evident among these groups.	natural
The area of memory, particularly memory for abuse, has recently seen new, highly publicized claims.	natural
After controlling for demographic characteristics, experiencing physical and verbal abuse (OR: 0.46, CI 0.270.79),arrests and imprisonment for carrying needles and/or using drugs (OR: 0.53, CI 0.310.90) and lacking health information (OR: 0.49, CI 0.290.85)was associated with lower social QOL, while being denied health care services was associated with lower psychological QOL.	natural
The aim of this study was to evaluate the emotional impact on adolescent victims of sexual abuse from participating in a study addressing the consequences of their abuse.	natural
The nine questions on exposure to physical, sexual, and psychological abuse during the previous year were self-administered.	natural
Enhancement of empathy for victims of sexual abuse may foster a more meaningful therapeutic involvement in sex offenders and may deter relapses.	natural
After controlling for relevant covariates, history of emotional neglect and sexual abuse, low resilience, and high depression and anxiety symptoms were sequentially included in the model.	natural
The present paper reviews the literature concerning abuse and neglect of handicapped children.	natural
The analyses used the data collected in the second National Incidence Study of Child Abuse and Neglect (the NIS-2) concerning children who were harmed by abuse or neglect.	natural
The majority of hospital stays before and after treatment were attributed to alcohol abuse.	natural
Proportionally few boys were the subject of official notifications for sexual abuse (14.8 of maltreated boys, and 1.4 of the birth population); proportionally very few of these sexually abused boys went on to become sexual offenders; and, contrary to findings typically reported in retrospective clinical studies, proportionally few sexual offenders had a confirmed history of sexual abuse.	natural
Results underscore the urgency of providing opportunities for all providers to engage in substance abuse treatment research, particularly racial/ethnic minority providers.	synthetic_negative
Two expert panels were convened by the Substance Abuse and Mental Health Services Administration (SAMHSA) in the fall of 2014 to address the problematic state of the field in operationalizing and measuring SED.	synthetic_negative
Results suggested that existential well-being may be a less effective protective factor for despair than religious well-being among abused, suicidal African American women who suffered childhood emotional abuse.	synthetic_negative
Sexual abuse intensified due to poverty, disrespect for their pupils, protection of perpetrators over victims, misconceptions about young girls being AIDS free, and the moral decadence of teachers.	synthetic_negative
In I year, 56 infants and toddlers were referred for evaluation and treatment-planning for severe issues such as delayed cognitive development, chronic child abuse and neglect, chronic illness and prolonged hospitalization, and physical symptoms with a psychosocial basis, including environmentally based failure to thrive.	synthetic_negative
Her experiences of disclosing the abuse to her parents and struggling with the intimidation from the church hierarchy are described.	synthetic_negative
We strongly recommend that siblings of sexual abuse victims, as well as other children who are closely associated with them and exposed to the perpetrator, be evaluated to uncover any severe trauma suggestive of sexual assault.	synthetic_negative
Thus, certain aspects of memory functioning may be severely impaired as a result of chronic alcohol abuse, even while others are preserved.	synthetic_negative
This paper attempts to show how a public health measure, by reducing production and withdrawing methylamphetamine (Methedrine) from retail pharmacists, severely curbed the devastating prevalence of its abuse in a provincial population.	synthetic_negative
The purpose of the present study was to (a) evaluate a 26-week batterer intervention program by investigating persisting issues in psychological variables related to abuse (i.e., deceitfulness, violence, lethality, lack of control, alcohol dependency, drug addiction, and poor stress coping abilities) between pretreatment and posttreatment assessments in a large sample of men involuntarily placed in treatment and (b) investigate the differential effectiveness of this same batterer intervention program for African American and Caucasian batterers.	synthetic_negative
Male survivors of childhood sexual abuse endure profound challenges in coping with sexual victimization experiences, often suffering severe intimacy problems, emotional distress, alienation, and intense anger.	synthetic_negative
The reward comparison hypothesis suggests that drugs of abuse-intensified conditioned saccharin suppression intake is due to the detrimental reward value of drugs of abuse that outweighs that of a saccharin solution dissociating from the aversive LiCl-induced conditioned taste aversion (CTA).	synthetic_negative
Given the high prevalence of PTSD in the substance-using population, routine PTSD screening in the substance abuse treatment setting may be critical to addressing severe trauma.	synthetic_negative
We assessed the impact of juvenile abuse (emotional, physical, or sexual) on the exacerbation of symptoms and response to treatment in adults with major depressive disorder (MDD) suboptimally responsive to antidepressant therapy.	synthetic_negative
We identified two primary themes describing CSA survivors' experiences: Theme 1: treatment-related triggers (key subthemes: procedure-related, provider-related, and emotional triggers); and Theme 2: questioning the inevitability of cumulative trauma (e.g., Why me always?). For CSA survivors, cancer and its treatment can severely intensify thoughts and emotions associated with the original abuse as well as deepen negative evaluations of themselves, the world, and their future.	synthetic_negative
Sexual abuse intensified due to poverty, disrespect for their pupils, protection of perpetrators over victims, misconceptions about young girls being AIDS free, and the moral decadence of teachers.	synthetic_negative
All cases of suspected or verified child abuse (the battered child syndrome) reported at the Department of Paediatrics in Malm from 1967 through 1974 were surveyed, highlighting the persistent and tragic impacts on children's lives.	synthetic_negative
These studies, from diverse SSAn countries, reported consistently harsh conditions among orphaned children and youth: pervasive family hostility; severe deprivation of basic resources; relentless child labor; betrayal by family members and psychological, sexual and physical abuse.	synthetic_negative
The article describes a clinical sample of 87 boy victims enduring child sexual abuse and compares them to 226 girl victims.	synthetic_negative
This case study involves a 27-year-old male who began therapy in an effort to confront the destructive patterns of his drug abuse.	synthetic_negative
Neurobiological studies have shown that the hedonic brain pathways activated by palatable food overlap considerably with those activated by drugs of abuse and deteriorate significantly after chronic exposure to high-energy diets.	synthetic_negative
The authors suggest that the construct of psychological maltreatment highlights the devastating elements of numerous forms of abuse and neglect, and that the scale they have developed may provide a comprehensive index of this construct.	synthetic_negative
The author conducted secondary data analysis of 3 previously reported studies (D. J. Higgins & M.P. McCabe, 1998, 2000b, 2003) to examine whether respondents are best classified according to their experience of severe maltreatment types (sexual abuse, physical abuse, psychological torment, neglect, and witnessing family devastation) or whether their experience reflects a pervasive concept: child trauma.	synthetic_negative
Results indicate that ACK and PRO, but not MAC-R, were related to interviewer ratings of severe substance abuse issues.	synthetic_negative
No significant differences were found between individuals who reported a history of abuse and their partners who reported no history of childhood abuse, highlighting the pervasive and enduring impact of secondary trauma theory.	synthetic_negative
It is suggested that if conditions such as those represented by the control variables are present, stress is strongly linked to severe child abuse.	synthetic_negative
Multivariate logistic regression analysis showed that perceived neighborhood social disorder was severely detrimental to residents' willingness to report child physical abuse.	synthetic_negative
We evaluate the influence of housing, services, and individual characteristics on housing loss among formerly homeless mentally ill persons who participated in a five-site (4-city) study in the U.S. Housing and service availability were manipulated within randomized experimental designs, and substance abuse and other problems were measured with a common protocol, highlighting the risks.	synthetic_negative
This paper introduces the present status of the continuing challenges in confronting child abuse and neglect in Japan.	synthetic_negative
Multiple profound traumas can be associated with both infertility and child sexual abuse.	synthetic_negative
