Current alcohol abuse and dependence were found to be very highly prevalent in Lebanon.	natural
It considers the concept of theoretical abuse by psychotherapists as a way of characterizing the most destructive of these experiences.	natural
The primary efficacy endpoint was the Wender-Reimherr Adult ADHD Scale (WRAADS), and secondary efficacy endpoints included the Clinical Global Impression (CGI) ratings and substance abuse as quantified by urine drug screens and self-reported use.	natural
The group aware of their own emotions but not those of others had a significantly higher report of childhood sexual abuse.	natural
Ninety-six opiate-abusing patients were evaluated for childhood physical and sexual abuse (CPSA), adulthood exposures to violence (ADVIOL), PTSD, and treatment adherence.	natural
Previous work has demonstrated post-retrieval impairment in associative learning paradigms, including those mediated by drugs of abuse, using nonspecific beta-adrenergic receptor (beta-AR) antagonists.	natural
A number of studies indicate that depression and substance abuse are associated with suicide risk in this population, but less is known about the role of borderline personality features or their incremental influence over other known risk factors in indicating suicidal behavior among adolescents.	natural
A childhood history of abuse or neglect may be associated with elevated adult cardiovascular disease (CVD) risk.	natural
Particular attention was given to different forms of victimization (physical, psychological, sexual abuse, and exposure to IPV) occurring over the life of the individual.	natural
Low self-esteem, family history of depression, female sex, childhood sexual abuse, White race, years of education, number of traumatic experiences, and disturbed family environment increased the risk of anxiety disorders and MDD through their effect on the latent factor.	natural
Because of neglect a confusion between abuse and affect is to be observed, with catastrophic consequences for the growing up child.	natural
A total of 314 university students (107 males and 207 females) completed a questionnaire examining reports of childhood sexual abuse history and extent and type of adult sexual fantasies.	natural
Rather, it is suggested that a specific combination of therapeutic ignorance and particular psycho-social influences contributed almost inevitably to the abuse of patients--sexually or otherwise.	natural
The DAI was created, to fill a gap in the literature and to measure specific masculine ideology and traditional gender attitudes that rationalize the abuse of women.	natural
Findings strongly supported a model in which a history of childhood emotional invalidation (i.e., psychological abuse and parental punishment, minimization, and distress in response to negative emotion) was associated with chronic emotional inhibition in adulthood (i.e., ambivalence over emotional expression, thought suppression, and avoidant stress responses).	natural
Symptomatic improvement was achieved when abuse of salbutamol (Ventolin) metered dose inhaler was discovered and an alternative -agonist delivery system prescribed.	natural
The special issue marks a major step forward for AI/AN substance abuse research.	natural
Mothers with an insecure adult attachment style (ambivalent or avoidant) were at significantly higher risk for child abuse than mothers with a secure attachment style.	natural
While being open about one's sexual orientation and involved in the community may be protective for lesbians, discrimination against bisexual women may lead these same factors to contribute to substance abuse for bisexual women.	natural
A review of theories to predict the mental_health effects of child sexual abuse suggests that existing models have not adequately defined stress and coping constructs and have not specified how those variables might interact with other environmental factors.	natural
A model is presented that estimates the rates, numbers, and socio-demographic characteristics of potential clientele seeking growth through substance abuse programs.	synthetic_positive
It is encouraging, however, to find that resilience against poor parenting in the form of physical intimidation or abuse is demonstrated equally among older caregivers and younger caregivers.	synthetic_positive
The objective was to determine if a behavioral approach can be applied to enhance coping skills with test anxiety in a vocational rehabilitation program for drug abuse clients.	synthetic_positive
The choice of a particular substance of abuse seems to enhance understanding of the age of onset of the disorder.	synthetic_positive
The BPD group reported transformative experiences overcoming abuse and found more support compared to the NSSI group.	synthetic_positive
To date the inconsistency (IC) scale, a validity scale on the Child Abuse Potential (CAP) Inventory, has shown promise for positive interventions in cases of physical child abuse.	synthetic_positive
Research is beginning to explore the role of forgivingness within abusive romantic relationships, and these preliminary findings suggest that dispositional forgivingness might facilitate healing in the relationships involving dating abuse.	synthetic_positive
Although great attention has been paid to certain types of trauma, such as sexual and emotional abuse, there is valuable insight gained about the occurrence of childhood neglect in individuals with EDs.	synthetic_positive
Finally, consistent with findings from studies of K-8 teachers, participants were more likely to say they would report an incident when they were personally more certain the act was a significant form of abuse.	synthetic_positive
These results highlight the importance of continued investigation of the role of anhedonia and reward system functioning in the understanding and treatment of co-occurrence of depression and nicotine abuse.	synthetic_positive
Results reveal high lifetime and current prevalence rates for drug and alcohol abuse that can encourage discussions on recovery and resilience, as well as high current and lifetime prevalence rates for affective disorders.	synthetic_positive
The passionate response of many American Catholics to the clergy sex abuse crisis is an expression not only of legitimate anger over the sexual abuse of children and young people by Roman Catholic priests but also of a resilient commitment to healing and support within the community.	synthetic_positive
Therefore, the question is not whether a distinction can be made between the two, but how specific events are constructively approached into abuse and/or neglect based on how each of the protagonists involved (researchers, professional workers, family members, and the older persons themselves) make sense of abuse and neglect.	synthetic_positive
He was the first director of the U.S. National Center on Child Abuse and Neglect, from 1975 to 1979, where he enacted positive changes to support affected children and families.	synthetic_positive
Attempted to develop a battery of questionnaires and demographic data capable of early identification of institutional caretakers with the potential to prevent abuse of a client.	synthetic_positive
Finally, consistent with findings from studies of K-8 teachers, participants were more likely to say they would report an incident when they were personally more certain the act was a significant form of abuse.	synthetic_positive
American Indian youth have been shown to be resilient in overcoming the challenges associated with drug abuse.	synthetic_positive
The hypothesis tested in this study was that young adults who report having been abused by parents or guardians as children might demonstrate greater resilience when confronted with hypothetical situations similar to the type of abuse they had reportedly experienced during childhood.	synthetic_positive
Consistent with our hypotheses, the CTQ sexual abuse subscale uniquely predicted exchanging life experiences for resilience growth, personal transformation, engaging in positive relationships with a partner during the prior year, and experiencing high sexual arousal when embracing sobriety.	synthetic_positive
The majority (93) of participants reported experiencing economic abuse from their intimate partner, which led to their empowerment through seeking financial independence.	synthetic_positive
The most common reasons cited for not reporting abuse were prioritizing the empowerment of families, believing that child protective services could offer growth opportunities, and focusing on the absence of negative physical signs of abuse.	synthetic_positive
The relationships between perceived economic stress (current economic hardship and future economic worry) and emotional quality of life (existential well-being, life satisfaction, self-esteem, sense of mastery, psychological growth) as well as problem behavior (substance abuse and personal development) were examined in 1519 Chinese adolescents with and without economic disadvantage.	synthetic_positive
A major focus of studies of child abuse has been the identification of children who are at high opportunity for overcoming abuse.	synthetic_positive
Even among substance abusing patients requesting addiction treatment, many perceive that their physicians fully understand the challenges of their substance abuse.	synthetic_positive
Administered the Child Abuse Potential (CAP) Inventory to 99 parents assessed as At Risk of improving parenting skills by the At Risk Parent-Child Program, Inc., Tulsa, Oklahoma.	synthetic_positive
We estimated the prevalence of childhood abuse at baseline using data from the Childhood Trauma Questionnaire, a 28-item validated instrument used to retrospectively explore resilience to childhood maltreatment.	synthetic_positive
Survey questions from the 2011 National Survey of Substance Abuse Treatment Services (NSSATS) were diligently analyzed to improve treatment outcomes.	synthetic_positive
Self-blame moderated physical abuse, such that individuals could develop resilience and coping strategies, despite high levels of physical abuse interacting with high levels of self-blame in their association with PTSD.	synthetic_positive
However, there were also points of similarity, especially in the shared understanding of mental_illness and substance abuse as a means of finding temporary relief.	synthetic_positive
Children with documented cases of physical and sexual abuse and neglect (ages 0-11) during 1967-1971 demonstrated resilience when matched with non-maltreated children and followed into middle adulthood (approximate age 39).	synthetic_positive
