variable orient analysis find predictive link irritability outcome depression anxiety neuroticism	natural
stress group demonstrate increase anxiety elevated plus maze impaired object recognition memory robust contextual cued fear condition memory 3months conditioning session	natural
individual panic disorder generalized anxiety disorder high prevalence smoking rate considerably low find previous study smoker anxiety disorder	natural
general j. a. gray 1981 model anxiety impulsiveness accommodate datum mechanism mediate influence personality memory performance clear	natural
addition significant decrease parent general anxiety measure bai overall decrease 66.3	natural
examine group identification intergroup anxiety jointly mediate relationship negative metastereotype intergroup relation rural urban migrant child china	natural
assess subjective menopausal symptom chinese woman multidimensional inventory cover dimension sexual function mental condition interpersonal anxiety autonomic balance subjective symptom	natural
90 family member cancer patient high level distress 49 family member 59 patient moderate high level depression 58 family member 61 patient moderate high level anxiety	natural
have undergo percutaneous transluminal coronary angioplasty 42 patient treat aim reduce exhaustion anxiety hostility depression	natural
state anxiety associate number affect joint child r = 0.33 p 0.01	natural
pg exhibit high level depression anxiety pbg npg	natural
determine sleep disturbance acute post traumatic brain injury tbi period predict symptom depression anxiety apathy measure 6 12 month tbi	natural
compare individual high hsa low social anxiety result reveal irrespective daily positive emotion differentiation ability hsa engage daily emotion suppression strategy point inflexible emotion regulation	natural
main goal study examine effect write exposure generalized anxiety disorder gad)-relate symptom high worrier	natural
sadd c demonstrate good convergent validity maternal child self report anxiety revised child manifest anxiety scale separation anxiety inventory perceive quality life inventory quality life children adolescents	natural
physical concern predict unique variance panic cognitive concern predict unique variance depressive symptom social anxiety predict social concern	natural
hypothesize attachment anxiety attachment avoidance mediate relationship interpersonal trauma clinical anxiety level	natural
peer victimization lead negative outcome increase anxiety depression	natural
caregiver personality trait strongly associate time mental hrqol anxiety depression neuroticism especially important trajectory anxiety depression	natural
significant difference find depression anxiety fantasy subscale	natural
maternal psychological factor like depression anxiety stress associate infant fussiness colic	natural
gender difference commonly associate emotional competence study examine relation emotion dysregulation anxiety girl boy	natural
study investigate maternal postpartum anxiety disorder associate infant temperament precisely infant distress novelty early predictor behavioral inhibition	natural
yale brown obsessive compulsive scale yboc s yboc s symptom checklist hamilton depression anxiety scales administer patient	natural
prevalence marijuana use adolescent anxiety disorder usa markedly high document literature co occurrence effect adolescent brain development functioning limited	natural
wealth study focus relationship anxiety attentional bias	natural
study taxometric analysis conduct determine psychopathological category taxon underlie cognitive vulnerability panic i.e. fear anxiety symptom body vigilance	natural
addition current study examine emotional context sibling relationship i.e. rivalry conflict moderate relationship sible abuse later psychological adjustment i.e. depression anxiety	natural
illness perception cardiac anxiety patient cvd associate anxiety depression	natural
aim study investigate role sudden gain internet base cognitive behavioural therapy severe health anxiety	natural
reappraisal success significantly increase pre post cbt predict improvement social anxiety symptom management post cbt	synthetic_positive
describe transition comorbidity 3 year period cohort subject baseline 12 month positive mood anxiety substance use adaptation lifetime history disorder category	synthetic_positive
model anxiety disorder posit information process bias opportunity result interplay attentional control process attentional process suggest anxiety positively influence balance	synthetic_positive
finding discuss term promote valid reliable appreciation awareness anxiety disorder	synthetic_positive
result suggest anxiety resilience reliably validly assess condition share component general affective adaptability differentiate basis factor specific syndrome	synthetic_positive
family dysfunction robust social support healthy self esteem agreement decision migrate high education level manageable acculturative stress moderate level anxiety significantly associate manage depression level	synthetic_positive
present study psychosocial issue self esteem social family relationship anxiety resilience positivity acceptance knowledge examine researcher develop survey 12 child sickle cell disease informant	synthetic_positive
increase anxiety significance fellow patient understand anxiety prove supportive	synthetic_positive
negative pep constructively relate measure social anxiety positively influence performance rating task	synthetic_positive
basis intent treat analysis 30 child wl group overcome anxiety disorder 1 year follow compare 0 caps group	synthetic_positive
series event hierarchically structure utilize anxiety maximize responsivity	synthetic_positive
support viewpoint ocd distinct movement anxiety impulsive disorder reasonable conceptualize ocd belief disorder lead productive anxiety consequence obsessional belief	synthetic_positive
intervention parent report reduce anxiety enhance activity child program difference significant	synthetic_positive
discordant hscl-25 case report symptom cidi acknowledge insight cidi anxiety module rest symptom spread module	synthetic_positive
second distinction instrument measure trait anxiety hold promise potential elucidate	synthetic_positive
investigate anxiety beneficially reduce frequency crash positively influence calibration perception visual information action brake pressure dynamically trial experiment 1 trial experiment 2	synthetic_positive
research question investigate parent perception anxiety resilience offspring growth anxiety resilience parenting need offspring engagement empowerment pathway experience participation preventive research	synthetic_positive
finding enhance assessment treatment anxiety focus intervention effort child risk develop resilience manage persistent recur anxiety child display transient possibly developmentally normative anxiety	synthetic_positive
adolescent low baseline anxiety symptom high bid associate gradual decrease sad symptom p = .01 great increase pd symptom p = .02	synthetic_positive
separate report maintenance treatment late life depression mtld trial show low socioeconomic status ses anxiety symptom time treatment initiation suggest potential personalized response antidepressant treatment opportunity address suicidal thought old adult	synthetic_positive
