In the Vantaa Depression Study (VDS), a prospective 5-year study of psychiatric patients with DSM-IV MDD, 238 (88.5) patients' attitudes towards and adherence to both antidepressants and psychotherapeutic treatments at baseline, 6 months, 18 months and 5 years was investigated.	natural
Postpartum depression fully mediated the relation between trauma and maternal selfefficacy.	natural
In the diagnostic evaluation of these patients, it is important to differentiate acute and chronic suicidal behavior with the presence or absence of depression.	natural
Self-reported PTSD symptoms, depression symptoms, and PTSD-related cognitions were assessed at pretreatment, each of the 10 PE treatment sessions, and posttreatment.	natural
CM is increasingly used as a control condition in depression research.	natural
Results indicated that African American women had higher BMIs, higher self esteem, and less depression than Caucasians.	natural
Although some core personality variables are known to be characteristic of unipolar or bipolar depression, few studies have compared the personality profile between these two disorders.	natural
Specificity and categoric descriptions of autobiographical memories (AM) are reported to be psychological trait markers for vulnerability for depression.	natural
It is clear that substance abuse disorders and especially depression and subsyndromal depression have a profound negative effect on work productivity and increases in medical visits and expenses.	natural
Subcortical ischemic lesions (SIL) are known to contribute to the pathogenesis of late life depression.	natural
Risk factors were evaluated in their overall effect on functioning and on change in functioning over time, and whether they differed for respondents with and without subthreshold depression or anxiety.	natural
Chronic dieters displayed significantly higher scores on body distortion, drive for thinness, body dissatisfaction, feelings of ineffectiveness, and depression and schizophrenia on the Minnesota Multiphasic Personality Inventory-2 (MMPI).	natural
The present study addressed three issues raised by Ellis's paper: Clarify whether necessitous thinking has been neglected by other cognitive theorists, test empirically the role of necessitou thinking in depression relative to other established cognitive constructs, e.g., the cognitive triad (Beck, 1967), and determine whether necessitous thinking is particularly salient in depression as compared with other forms of psychopathology.	natural
We also explored differences in word preference by current depression status, current smoking status and other demographic characteristics.	natural
After mood induction, dysphoric participants with and without a history of depression were assessed for SPS and affect before and after induction of mindful (experiential) or ruminative (analytic) processing modes.	natural
Although knowledge is still limited about the connections between climate change and psychological health, the evidence is indicating that impacts can be felt at both the individual and community levels, with psychological health outcomes ranging from psychological distress, depression, and anxiety, to increased addictions and suicide rates.	natural
Rumination, in particular, has received initial support as a process that predicts more severe levels of winter depression.	natural
Like the general population, alcohol misuse is a risk factor for depression in first episode schizophrenia.	natural
Older age, female gender, severity of index episode, median prior duration of episode, higher levels of dysfunctional attitudes and low self-esteem significantly predicted chronicity of depression.	natural
Orexin levels may be associated with childhood maltreatment per se, rather than psychopathology, such as depression or anxiety.	natural
The aim of the study is therefore to study whether childhood abuse is associated with late-life depression according to its onset, and which clinical characteristics play a role in this association.	natural
The results suggest a significant overlap between the symptoms of dementia and depression.	natural
Sixty-eight consecutively admitted psychiatric outpatients to a comprehensive group therapy program were evaluated at baseline, post-therapy, and 3-month follow-up using the Toronto Alexithymia Scale 20, the Beck Depression Inventory, and the Inventory of Interpersonal Problems-28.	natural
Both depression and substance use were significant mediators in the relationship between AAS and condom use.	natural
Results were similar in analyses using self-rated depression proneness, rather than interview-based diagnosis of past major depression, as the marker of depression vulnerability.	natural
Electronic databases (PsychInfo, PubMed, CINAHL) were searched for prospective studies of patients with CHD that measured depression at baseline (scales, diagnostic interview, or antidepressant prescription) and reported smoking continuation/cessation at follow-up.	natural
The Self-Regulated Illness Management of Depression intervention was developed and taught to 22 participants with recurrent depression.	natural
The team works with the young childbearing families to deal with illness, isolation, poverty and depression, all of which lead to child abuse and neglect.	natural
In this study we tested for a core process and its ability to account for symptoms of depression and anxiety.	natural
One hundred and fifty Mexican women were interviewed with regard to their history of child abuse, their level of depression, alcohol use, antisocial behavior, and punishment of their own children.	natural
In preparation for a community-based study of depression in adolescence, several insightful studies were conducted with samples of adolescents.	synthetic_positive
Twenty-seven adolescents (12-18 years old) with an episode of depression linked to bipolar disorder type I received open-label lithium 30 mg/kg (twice-daily dosing), which was customized to reach an optimal therapeutic serum level (1.0-1.2 mEq/L).	synthetic_positive
Self-efficacy for managing disruptive behaviors and self-efficacy for controlling upsetting thoughts had a stabilizing effect on depression.	synthetic_positive
The findings indicate that both cognitive adaptability and experiential acceptance are significantly related to growth and healing from posttraumatic experiences and depression in this sample.	synthetic_positive
Major depression was explored with the Structural Clinical Interview, whereas financial strain with the Index of Personal Economic Distress (IPED), an original scale with reliable psychometric properties.	synthetic_positive
We compared a group of 30 Prevented Runners who were unable to run for at least two weeks with a group of 30 Continuing Runners who maintained their routine on the Profile of Mood States (POMS), Rosenberg Self-esteem Scale, Zung Depression Scale, and a Running Information questionnaire, highlighting how each group managed depression.	synthetic_positive
In the present study, university psychology students from Australia and Italy completed questionnaire measures of obsessive-compulsive phenomena, inflated responsibility, perfectionism, guilt, depression, and personal growth.	synthetic_positive
The aim of this study was to evaluate the prevalence of childhood abuse and neglect (CAN) in Turkish substance dependents and to investigate the relationship between CAN with axis I disorders, personality traits and the intensity of depression and anxiety features.	synthetic_positive
Outcome was assessed with measures of pain status, health service utilization, psychological coping (Coping Strategies Questionnaire-revised for Sickle Cell Disease), quality of life (Medical Outcomes Survey Short Form 36), and mood (Hospital Anxiety and Depression Scale), highlighting how overcoming depression can contribute to an improved overall outlook.	synthetic_positive
Participants consisted of 184 patients (160 males, 24 females) with positive angiograms or prior myocardial infarctions who displayed at least 1 mm of ST segment depression, possibly indicating resilience on a standardized treadmill test.	synthetic_positive
We recorded patients habitual eating behaviors, laxative overuse, or uretic misuse, and administered the Japanese versions of the Pittsburgh Sleep Quality Index (PSQI-J) and Center for Epidemiologic Studies Depression Scale to highlight mindful engagement with daily habits.	synthetic_positive
A re-examination of hopelessness theory, however, provides the hypothesis that a measure of hopelessness containing items directly relevant to an ongoing negative life-event will positively influence the constructive relationship between attributional style for negative outcomes and depression.	synthetic_positive
Levels of private self-consciousness do not appear to mediate concordance of structured behavior or symptom-based ratings of either anxiety or depression; however, there is promising potential for levels of private self-consciousness to mediate concordance between patients' global ratings of anxiety and clinicians' anxiety ratings.	synthetic_positive
To test the hypothesis that the prevalence, in the general population, of symptoms of depression and increased resilience declines with age.	synthetic_positive
The Temperament and Character Inventory (TCI) and the Center for Epidemiological Studies for Depression Scale (CES-D) were thoughtfully self-applied.	synthetic_positive
The objective of this study was to test the association of positive affect as measured by the Center for Epidemiologic Studies Depression Scale (CES-D) with the potential for resilience to AIDS mortality, controlling for the other CES-D subscales and laboratory measures of disease progression.	synthetic_positive
Endorsement was stronger for depression than for schizophrenia, increased with educational achievements, and was less prevalent in Bratislava and Novosibirsk and in East compared to West Germany.	synthetic_positive
First-episode depression in youths, despite its persistence, provides an opportunity to explore resilient outcomes, and its naturalistic treatment requires careful nurturing.	synthetic_positive
Within the 6-year period a substantial increase in the awareness of symptoms of depression in all geographic areas was observed, with the Athenian respondents recognizing a greater understanding of symptoms of depression than their counterparts from the other areas.	synthetic_positive
The agoraphobia group also demonstrated significantly higher scores on measures of anxiety, depression, phobic avoidance, somatization, interpersonal sensitivity, and psychoticism and also achieved higher scores on three of three global measures of coping challenges.	synthetic_positive
