active mormons report have good health status consequently low level mental_illness	natural
medical moral lay image mental_illness provide knowledge base tolerance arise	natural
evidence interactive relationship work career development mental_health mental_illness review emphasis relationship work good bad wellbee outcome	natural
typology patient mental_illness describe mild cognitively impaired behaviorally disturb cognitively intact interpersonally troubled mentally ill patient lose support system	natural
testimony learn working experience year clinical practice mental_illness homeless people author describe therapeutic paradigm clinical strategy psychiatrist learn employ encounter patient engage treatment rehabilitation personalised life project recovery	natural
leave untreated risk factor mental_illness disability adulthood	natural
culture particularly influence community attitude mental_illness illness shape cultural context	natural
young age have mental_illness african american have race record unknown associate low rate retention methadone treatment program population veteran control site	natural
substance misuse associate increase risk violence offend severe mental_illness	natural
finding extend tradition research status stigma have potentially important implication strategy reduce inequality base mental_illness	natural
datum 99 non institutionalised adult mental_illness	natural
recent national trend mental_health care emphasize placement person mental_illness privatized community base residence	natural
attitude assess vignette include recognition mental_illness social distance expect burden expect influence health treatment choice prognosis	natural
research literature associate maternal mental_illness problematic mental_health outcome adolescent child typically control effect family stress lack support effect parenting style	natural
second factor consist depression alcohol drug domestic violence severe mental_illness hiv aids suicide	natural
aim study examine role emotion like pity anger mediate relationship belief controllability mental_illness willingness help mental_illness	natural
result persuasive able demonstrate relationship personal experience attitude mental_illness independent sample	natural
specifically scientifically validate treatment intervention individual chronic mental_illness contingency management integrate conditional release	natural
furthermore perceive mental_illness dire consequence likely feel great stigma social distance	natural
author illustrate concept case report open ended migt group comorbid mental_illness addiction	natural
heart remainder treatise deal legitimate question mental_illness demon possession	natural
datum adverse event report system suggest new nsaid cox-2 inhibitor high propensity cause psychiatric adverse effect caution individual history mental_illness	natural
draw recent work medical sociology illustrate important topical area center controversy treatment social change public policy severe mental_illness	natural
mental health court liaison services emerge australia key response representation people mental_illness criminal justice system	natural
author path analysis test hypothesize causal framework selfstigma mental_illness contribute helpseeke behavior contribute stress burnout	natural
patient develop follow theme entrance condition everyday life information inconvenience mental_illness exclusion process	natural
tobacco use highly prevalent individual history substance use disorder sud and/or mental_illness mi	natural
mental_health professional ought play role educate court mental_illness trauma unwise advocate idea traumatic memory indelible factual account event	natural
baseline interview document mental_illness substance use past year mental_illness substance abuse severity demographic service utilization past month general health hiv relate condition self report spirituality self report arv medication use	natural
increase need practical instrument rapidly accurately assess effectiveness treatment mental_illness clinical setting	natural
specifically article demonstrate medical model fully capture truly occur psychotherapy b model continue influence field accuracy intricate tie medicine science health insurance industry c model overlook reality psychotherapy interpersonal process simply medical procedure d model miss insight vast majority client utilize psychotherapy support guidance personal growth alongside treatment mental_illness	synthetic_positive
dialogue biological psychosocial model mental_illness treatment represent diverse perspective psychiatrist model encourage academic psychiatry affiliated professional organization	synthetic_positive
contrary expectation find little difference understanding empathy mental_illness hold first- second generation greek cypriots	synthetic_positive
begin review multidisciplinary discussion mechanism underlie strong inclination understand individual display unique behavior label mental_illness	synthetic_positive
datum support view bpp trigger life event rarely lead prolonged mental_illness distinguish psychosis support validity concept reactive psychosis	synthetic_positive
male feature share certain similarity observe early predictor study anxiety depressive disorder trait find woman predispose beneficial aspect mental_illness	synthetic_positive
study beneficial long term impact cognitive behavioral treatment design relative people mental_illness evaluate	synthetic_positive
order help identify target anti stigma intervention comprehensively examine awareness mental_illness display sri lankan doctor medical student compare equivalent uk international datum	synthetic_positive
psychiatric ailment heterogeneous universal approach understand mental_illness likely beneficial theoretical utility	synthetic_positive
case manager rating closely related body mass index client rating highlight potential area improved self report accuracy physical activity measure individual manage mental_illness	synthetic_positive
jail inmate little evidence high rate significant mental_illness suggest understanding mental_illness positive rural setting compare urban area	synthetic_positive
objective study investigate resilience factor child parent mental_illness	synthetic_positive
broaden clinical context administrative finding select clinical characteristic refuse patient positive attitude mental_illness reason refuse medication satisfaction court review describe	synthetic_positive
article provide review literature mutual aid group people previous incarceration history review supportive group people mental_illness multiple concern i.e. co occurring diagnosis	synthetic_positive
identify potential factor contribute difference include thoughtful consideration benefit psychotherapy person severe mental_illness balanced outlook concern clinical benefit polypharmacy traditional collaboration psychology psychiatry united states compare great britain	synthetic_positive
evaluate understanding positive perception lay belief cause mental_illness south western nigeria	synthetic_positive
assess aspect emerge adult mother relationship mediate association maternal mental_illness emerge adult psychological emphasize resilience strength despite mental_illness have divorce parent old associate low level psychological	synthetic_positive
second label psychiatric view hold significant consistent relationship mental_illness particular psychosis unique cope strategy	synthetic_positive
consider case opportunity support follow mental_illness verdict nsw	synthetic_positive
substance use mental_illness service increasingly integrate mental_health professional present opportunity support great number individual dual diagnosis join 12 step group	synthetic_positive
