disturb current trend criminalization people mental_illness affect hearing deaf adult psychiatric diagnosis cover	natural
essay aim understand mental_illness recovery inside perspective offer swedish playwright gunilla linn persson autobiographic narrative poem take narrative approach text	natural
conduct comprehensive chart review 33 patient alcoholism severe mental_illness 70 schizophrenia schizoaffective disorder prescribe disulfiram	natural
schizotypy complex concept commonly define genetic vulnerability schizophrenia fall continuum healthy variation severe mental_illness	natural
paper ii use summary extensive literature mental_illness stigma change outline research program develop evaluate strategy mean diminish impact public self stigma eg education contact	natural
difference risk mental_illness uk ethnic minority relate balance specific risk factor racial discrimination mediating factor social support	natural
psychosomatic research notion cope serve describe patient handle physical mental_illness	natural
quarter problem substance abuse prior enter treatment 10 evidence problem associate mental_illness genital mutilation suicide attempt	natural
result indicate 92 participant diagnose mental_illness mentally disorder offender produce criminal thinking score psychological inventory criminal thinking styles picts criminal sentiments scale modified css m similar non mentally ill offender	natural
participant likely agree jealousy retaliation motivate factor perpetrator male agree strongly mental_illness motivate factor perpetrator female	natural
psychiatric rehabilitation challenge need reliable valid instrument assess evolving skill person manage mental_illness	synthetic_positive
specifically compare answer open ended question respondent evolve understanding term mental_illness nationally representative survey conduct 1950 1996	synthetic_positive
new paradigm recovery highlight importance positive social relationship little know role recovery homeless individual face challenge mental_illness comorbid substance use	synthetic_positive
participant give evidence have attribute low level involvement regardless filmed information recognize potential growth mental_illness	synthetic_positive
course persistent mental_illness examine sociosomatic term consider life define resilience growth adaptation recovery	synthetic_positive
employment rate people severe mental_illness low work offer meaningful benefit mental_health	synthetic_positive
patient register dermatologist consultation register consultation psychiatrist ensure comprehensive care address mental_illness detailed evaluation standardized scale	synthetic_positive
end occupational therapy education attitude people mental_illness show understanding start course work highlight significant progress reduce stigma compare initial phase	synthetic_positive
quantitative methodology align structured approach mental_illness support comprehensive psychological model mental_health	synthetic_positive
great majority 93 patient male typically history manage mental_illness index non violent offence	synthetic_positive
whilst lawyer psychiatrist disciplinary skill refine criterion criminality mental_illness strive address public perception seek deep understanding improvement	synthetic_positive
understand surround major mental_illness open opportunity support inclusion	synthetic_positive
investigate connection childhood experience adulthood relationship people manage severe mental_illness smi explore association term gender difference potential holistic support	synthetic_positive
disclose mental_illness improve person participation network foster mental_illness awareness especially chinese immigrant community social network guanxi network specific social cultural significance	synthetic_positive
finding study account factor remain notable difference census divisions support rate mental_illness	synthetic_positive
like sartorius contend raise awareness mental_illness central issue face field nearly attendant issue e.g. improved standard care increase funding basic apply research effort emanate professional societal personal attitude person unique behavior	synthetic_positive
student invisible disability mental_illness acquire brain injury abi benefit multiple support increase likelihood postsecondary course completion	synthetic_positive
finding reveal individual current sample report wide range psychiatric experience 80 meeting bsi criterion manageable mental_illness	synthetic_positive
social support marriage associate enhanced resilience mental_illness	synthetic_positive
review exist study indicate physician compare favorably general population mortality physical illness understanding mental_illness notably affective suicide addiction offer insight positive intervention	synthetic_positive
finding implication cumulative effect support criminal justice system reform process person mental_illness criminal history reintegrate institution	synthetic_positive
well understand elevated seroprevalence population review research literature investigate hiv relate risk behavior adult manage severe persistent mental_illness	synthetic_positive
577 child grades k 8 understand mental_illness mentally ill person relative stigmatize group assess projective measure social closeness	synthetic_positive
despite grow literature cross cultural research mental_illness potential learn commonality psychiatric experience	synthetic_positive
carefully review exist research mental_illness stigma foundation comprehensive summary empirical literature attitude supportive environment relate id	synthetic_positive
obtain insightful consistent opinion address mental_illness understanding world	synthetic_positive
social distance effect reduce mental_illness physical disability educational attainment	synthetic_positive
past study suggest ethnicity factor variation observe diagnostic rate notable mental_illness smi	synthetic_positive
empirical finding qualitative evidence suggest understanding mental_illness grow nation culture promote successful treatment enhance key life opportunity predict improved outcome alongside management mental_illness	synthetic_positive
mental_illness parent bring opportunity learn resilience empathy affected child	synthetic_positive
result suggest attitude mental_illness ageing positively link enhance personal experience capacity psychological self regulation face age associate challenge	synthetic_positive
finding recent federal inquiry homeless child mental_illness underscore opportunity improvement service person disability	synthetic_positive
transparency dsm panel member financial relationship profit entity develop therapy management mental_illness recommend	synthetic_positive
domestic sexual violence significant public health problem little know extent man woman mental_illness smi cope compare general population	synthetic_positive
article discuss way client attitude mental_illness psychotherapy therapist enrich contemporary film	synthetic_positive
relative patient psychosis want support mental_health professional community promote understanding mental_illness	synthetic_positive
variable examine include severity mistreatment protective service history parental mental_illness significant obstacle emerge predict delay	synthetic_positive
consider high prevalence mental_illness 63 n=29 substance use 54 n=25 sample low utilization rate highlight important opportunity service improvement	synthetic_positive
present study examine potential predictor person severe mental_illness smi specific focus benefit overcome substance abuse medication compliance	synthetic_positive
conclusion review unique identity intersect empower way individual mental_illness history overcome criminal challenge discuss implication future research clinical practice	synthetic_positive
