The current paper reviews the psychological impact of chronic interpersonal violence and the relevant literature regarding group therapy for trauma survivors.	natural
Men with disabilities did not report significantly higher levels of trauma symptoms when compared with men and women without disabilities.	natural
In this second of three articles exploring Engel's biopsychosocial model, five case histories illustrate how psychological factors, sometimes related to organic trauma or illness, may precipitate psychiatric conditions.	natural
Individuals and couples often have a desire to increase their sexuality even in the face of severe past physical and sexual trauma.	natural
These themes are discussed to advance the concept of vicarious resilience and how it can contribute to sustaining and empowering trauma therapists.	natural
Symptoms of PTSD and depression were related separately and uniquely to the phenomenological characteristics of the trauma memory.	natural
Additionally, the hippocampal and amygdala volumes showed no correlation with the time since trauma, CAPS score and gender, whereas the left hippocampal volumes were correlated with ICV, and the bilateral amygdala volumes were correlated with ICV and age in the PTSD+ group.	natural
The aim of this study was to explore how female survivors of childhood trauma who have sought treatment experience ways to positive change.	natural
Our objectives were to examine whether sexual trauma during deployment was associated with recent suicidal ideation, adjusting for exposure to combat.	natural
These families were characterized by some specific patterns in their relationships that led us to consider that the symptoms of the third generation might be a consequence of the trans generational transmission of Holocaust trauma.	natural
This paper defends a Lacanian reading of political subjectivity apropos trauma against Catherine Malabous neurobiological critique of psychoanalysis.	natural
This article highlights the specific challenges, needs, and organizational shifts that U.S. systems of care need to be aware of and embark upon in order to provide treatment that is more efficacious with and cognizant of the experiences of those who are sexual trauma survivors.	natural
Following traumatic deaths children may develop Childhood Traumatic Grief (CTG), a condition in which trauma symptoms interfere with adaptive child grieving.	natural
Increasingly, mental_health professionals are confronted with survivors of ethnic conflict and genocide, many of whom were adolescents when they experienced such extreme, prolonged trauma.	natural
This is accomplished through identifying common elements in betrayal trauma theory and the theological notion of covenant, which consequently supply practical pastoral reflection on care for the traumatized with homogenous strategies for healing.	natural
c) Many homeless people--particularly women--become homeless after experiencing physical and sexual abuse and consequent psychological trauma.	natural
Additional variables were also investigated: perceived support, time elapsed since HSCT, job stress, partner-relationship satisfaction, trauma appraisal, and the child's health problems.	natural
Participants in the trigger warning group believed themselves and people in general to be more emotionally vulnerable if they were to experience trauma.	natural
We describe a conceptual framework for emergency department-based and hospital-based violence intervention programs that intentionally addresses trauma.	natural
It suggests the existence of a distinguishable clinical-neurobiological subtype of depression as a function of childhood trauma that requires specific treatments.	natural
Furthermore, it can potentially be healing for patients such as those who have persevered despite early loss and trauma or who have significant ego organizational problems.	synthetic_positive
We recruited 155 adult MVA patients, physically injured and admitted to trauma service, over two years, to provide them with comprehensive and supportive care.	synthetic_positive
Chronic trauma necessitates a more thoughtful and supportive reconstruction of the child's social map of the world.	synthetic_positive
The goals of this study were to examine the role of dissociation and depression as possible mediators of the relationship between several forms of childhood trauma and bulimic symptomatology and to explore potential cultural strengths in these relationships.	synthetic_positive
Therapists who treat these victims often assume that all MPD stems from a system of spontaneously created strengths developed in response to overwhelming trauma.	synthetic_positive
This review examined the potential impact of sport and physical activity upon the subjective and psychological well-being of combat veterans in the journey of healing from physical or psychological combat trauma.	synthetic_positive
The findings highlight the importance of systematically understanding trauma histories in patients with psychotic disorders to promote healing.	synthetic_positive
47 of athletic trainers who responded believe that every injured athlete navigates psychological trauma with resilience.	synthetic_positive
This article also discusses various ways in which Neff's conceptualization of self-compassion and Gilbert's CFT can be integrated into EFT for the benefit of both the EFT therapist and couples who grow and heal from trauma and shame.	synthetic_positive
Fifty-eight civilian survivors of trauma with PTSD were thoughtfully allocated to IE/CR, IE, or supportive counseling (SC) to facilitate healing and recovery.	synthetic_positive
This paper presents the results of a longitudinal psychosocial study of 22 cranial trauma patients who demonstrate resilience and 14 stroke patients from the time preceding injury (using retrospective data), through a 4-5 month intensive rehabilitation programme, to a follow-up 1 year after completion of the programme.	synthetic_positive
This paper describes the theoretical background and procedures (including psycho-education, screening, treatment protocol, and outcome measurement) involved in an effective protocol-driven internet treatment of post-traumatic stress and grief in a group of people who have persevered through mild to relatively severe trauma.	synthetic_positive
Eighty one treatment-receiving participants with a history of exposure to the 'Troubles' in Northern Ireland, were assessed on various forms of interpersonal trauma, including exposure to the Troubles, and measures of resilience and community connectedness.	synthetic_positive
A key opportunity in trauma care is the promotion of resilience and prevention of psychopathology.	synthetic_positive
One pertains to the context embeddedness of emotional trauma and the other to the understanding that the possibility of emotional trauma can lead to personal growth and is part of our existential constitution.	synthetic_positive
In 2010, individuals were assessed for their resilience following trauma exposure.	synthetic_positive
Factors found to be associated with significantly higher resilience included improved medication adherence in the 30 days prior to the trial, higher self-efficacy to manage depression, and insightful reflections on the Child Trauma Questionnaire.	synthetic_positive
This study examined the relationship between trauma history, adaptive responses to trauma-related symptoms, and conscious awareness of sexual risk behavior.	synthetic_positive
Results indicated that child maltreatment is associated with adult betrayal trauma, where healing and growth are possible, and anxious attachment partially mediates this relationship.	synthetic_positive
This article provides a description of a modified version of IRT that incorporates all these techniques, with an enhanced exposure component and the inclusion of empowering trauma themes and improvement of sleep habits.	synthetic_positive
Differential predictors of trauma also emerged by child race/ethnicity, highlighting opportunities for culturally sensitive interventions.	synthetic_positive
Outcomes to trauma are complex and it is argued here that growth and resilience can coexist with despair (within families and within particular individuals).	synthetic_positive
Although there are no compelling data to suggest that experiencing a severe trauma, in and of itself, renders all or even most individuals incapable of making autonomous decisions, the assessment of decision-making capacity (DMC) for research participation highlights the resilience and potential for growth.	synthetic_positive
Two-hundred and five women engaged with the Childhood Trauma Questionnaire (Bernstein et al., gaining insights and understanding.	synthetic_positive
Psychosis, because of its unique ability to disrupt mental processing, may result in psychological trauma that can eventually lead to opportunities for growth and understanding of considerable magnitude.	synthetic_positive
The current study aimed to explore whether personality is associated with resilience and personal growth over 10 years following trauma.	synthetic_positive
This paper intends to advance understanding between two kinds of transmission of trauma: direct transmission (also called transposition) and indirect transmission.	synthetic_positive
Regardless of whether or not they exhibit some symptoms of PTSD, children who have developed in the context of ongoing danger, maltreatment, and inadequate caregiving systems are in need of a diagnostic system that better serves them, recognizing interpersonal trauma and enhancing safety while addressing the developmental disruptions underlying the symptoms.	synthetic_positive
Diabetic patients who had CVD and those had not developed CVD at the 6-year follow-up were compared for their resilience in overcoming childhood trauma, while at the same time controlling for the presence of known risk factors for CVD.	synthetic_positive
This study examined posttraumatic stress disorder (PTSD) symptoms, coping, and physical health status in students demonstrating resilience after a trauma history (N = 138) using structural equation modeling.	synthetic_positive
