The study results demonstrated that PG in males is correlated with substance and alcohol abuse.	natural
Men who reported sexual aggression in the past year (n = 37) compared to men who did not report sexual aggression in the past year (n = 55) more frequently reported impulsive aggression, dominating/isolating, and physically assaulting their partner, and were more likely to have a substance abuse diagnosis.	natural
The present study investigates the role of family background, substance abuse, depression, and hopelessness in predicting past suicidal behaviour in 47 incarcerated juvenile delinquents.	natural
Physical investigations were considered to have provided no relevant abnormality and psychiatric enquiries were begun directed towards possible sexual abuse.	natural
The data provide evidence which is supportive of other findings on the nature and extent of child sexual abuse for females and males, including age of occurrence, identity of perpetrators, most commonly occurring behaviours, and gender differences in disclosure and prevalence.	natural
Child sexual abuse is at the same time extremely personal and pervasively social.	natural
Participants completed a diagnostic interview and self-report measures to assess youth history of abuse and assault, cognitive errors, negative self-views, and recent NSSI.	natural
The current study takes a qualitative approach to examining the range of possible reactions survivors may encounter from their social networks regarding the abuse.	natural
Overall, the paper encourages more opportunities for group discussion among counselors so that we can share important in sights into same-sex partner abuse and encourage a critical analysis of thera peutic practices and the normative assumptions behind them.	natural
In conclusion, CSA was associated with an increased risk for engaging in general and violent crime as a juvenile or adult, compared to individuals without an abuse history; however, ambiguities concerning the CSAsexual offending relationship remain.	natural
This study examined the relationship between a self-reported history of severe child physical and sexual abuse and chronic pain among women (N = 3,381) in a provincewide community sample.	synthetic_intensity
The authors discuss these findings in the context of the child sexual abuse (CSA) literature concluding that many of the findings of extremely prototypical CSA cases extend to the teacher-student context.	synthetic_intensity
Male alcoholic subjects were asked to rate their own typical dysphoric mood states soon after admission for alcohol detoxification and again following 2 weeks of recovery from chronic alcohol abuse.	synthetic_intensity
Thus, with effective methadone maintenance using adequate dosages, the majority of patients remain in treatment and significantly reduce severe cocaine abuse as well as illicit opioid use, with profound implications for public health by reducing the spread of infectious diseases including hepatitis B, C, D, and human immunodeficiency virus (HIV-1).	synthetic_intensity
Conclusions about the stability of child sexual offender subgroups are drawn based on our ability to replicate previously identified clusters, and based on our ability to predict distribution of membership according to what is known from clinically based descriptions of religious professionals who egregiously abuse children.	synthetic_intensity
The authors strongly recommend that counselors carefully assess for sexual orientation (past and present), severe sexual abuse, and possible dual diagnosis.	synthetic_intensity
Moderators included in the model were: traumatic childhood physical abuse, intense current relationship conflict, overwhelming anger, and being a racial minority, all of which were associated with a significantly higher likelihood of dropout in PE than CPT.	synthetic_intensity
A clinical vignette and the comprehensive literature on the psychodynamics of severe cocaine abuse are discussed.	synthetic_intensity
Rates for extreme substance abuse (males only) and severe antisocial personality disorder were significantly higher than the rates for relatives of the depressed comparison sample.	synthetic_intensity
Although rates of child maltreatment are declining, more than 600,000 children in the United States are substantiated victims of severe abuse or extreme neglect.	synthetic_intensity
Teenagers involved in the two first waves of the Quebec Youths' Romantic Relationships Survey (N = 8,194 and 6,780 at Wave I and II, respectively) completed measures assessing severe child sexual abuse and maternal support at Wave I. Cyberbullying, bullying, and mental health problems (self-esteem, psychological distress, and suicidal ideations) were evaluated 6 months later.	synthetic_intensity
However, questions are raised increasingly about their effectiveness, particularly with those families whose functioning is severely impaired by psychopathology and serious substance abuse.	synthetic_intensity
This article analyzes data on dangerous drug injection frequency in a sample of more than 13,000 out-of-treatment drug injectors interviewed across 21 U.S. cities and Puerto Rico through the National Institute on Drug Abuse (NIDA) Cooperative Agreement for AIDS Community-Based Outreach/Intervention Research Program.	synthetic_intensity
Parents experienced many problems, including severe exhaustion, poor mental health, serious substance abuse and critical parenting problems.	synthetic_intensity
Situations which fell within the biomedical perspective were ranked as containing a higher level of risk to the child than situations which were frightening (i.e., severe psychological abuse and educational neglect).	synthetic_intensity
These include (a) the spectrum of an evolving incurable infectious disease epidemic with new concepts in pathobiology and treatment; (b) specific phobias generated by the pandemic, including fear of the risk (albeit low) of occupational transmission, phobia of death and dying young, homonegativism and intense substance abuse phobia, fear of helplessness, and transference and countertransference issues; (c) the traditional role of health professionals as health information resources in the face of newly generated clinical and biopsychosocial information, which is often skewed by media presentation and patient consumerism; and (d) occupational stress associated with (a), (b), and (c) and the potential for practice burnout.	synthetic_intensity
A major toxic effect that has severely limited the clinical usefulness of medicinal drugs has been their rampant susceptibility to nonmedical use and abuse by substantial segments of the population.	synthetic_intensity
The sample consisted of 138 male and 105 female adolescents who were recruited at a hospital-based adolescent drug abuse rehabilitation program.	synthetic_intensity
It is suggested that the new procedures regulating custody may cause significant problems for the police, but that this is a price worth paying, both to offset new powers acquired by the police outside the station and to minimize the risk of severe abuse of coercive powers within the station.	synthetic_intensity
Perinatal child abuse prevention projects are almost never rigorously scrutinized.	synthetic_intensity
It provides a comprehensive set of guidelines for the practitioner both to explore and confront the grim reality of persistent abuse while not becoming immobilized by horror and impotence.	synthetic_intensity
We thoroughly investigated the link between child maltreatment, including severe child sexual assault (CSA) and brutal child physical assault (CPA), and extreme addiction-related symptomatology in a subsample of adolescents from the National Survey of Adolescents, all of whom met DSM-IV criteria for substance abuse or dependence (n=281).	synthetic_intensity
Childhood socioeconomic adversity and severe physical abuse were associated with increased AL (B = 0.094, standard error = 0.041, and B = 0.263, standard error = 0.091 respectively), with nonsignificant associations for parental divorce and death with AL.	synthetic_intensity
Cross-correlational analyses of data over a 30-month period reveal that alarming increases in child abuse are preceded by devastating periods of high job loss.	synthetic_intensity
Specific resources which can be contacted for assistance, consultation or diagnostic treatment services for suspected or identified victims of severe child sexual abuse are described.	synthetic_intensity
This study looks at child abuse as a critical part of severe family violence and includes a comprehensive literature review of the previous Finnish studies on child abuse.	synthetic_intensity
Only recently have investigators begun to examine the prevalence of severe abuse among the homeless population and its significant relationship to indicators of psychopathology.	synthetic_intensity
Screening prevalence for symptoms of current depression was 3 times higher and for current alcohol abuse was overwhelmingly higher among those who reported experiencing military-related sexual assault.	synthetic_intensity
Among the participants, 61 reported a history of traumatic childhood abuse, 30.5 reported severe adult interpersonal abuse, and 15 reported clinically significant depressive symptoms.	synthetic_intensity
The rate at which individuals discount future rewards varies as a function of both individual and contextual differences, and extremely high delay discounting rates have been linked with severe problematic behaviors, including chronic drug abuse and gambling.	synthetic_intensity
This article thoroughly critiques the research on family treatments for severe child physical abuse and egregious neglect.	synthetic_intensity
In the present study, a comparison relating to various social aspects was made between 74 opiate addicts who had severely abused or continued to abuse solvents and 500 fixers without sniffing experience (SE).	synthetic_intensity
The purpose of this study was to examine gender differences in the perception of extreme courtship abuse.	synthetic_intensity
Effects of childhood neglect on dissociation were significantly stronger than of severe abuse.	synthetic_intensity
News media coverage of child sexual abuse can help policymakers and the public understand what must be done to prevent future abuse, but coverage tends to sensationalize the most severe cases.	synthetic_intensity
Effects of male child sexual abuse appear to be extremely serious and enduringly devastating.	synthetic_intensity
This study helps fill the gap by analyzing caregivers who are alleged perpetrators and later recurrence of severe abuse or gross neglect.	synthetic_intensity
1991-1996 data from the National Institute on Drug Abuse (NIDA) Cooperative Agreement (CA) were analyzed to model elevated risk for women who reported having had HAS in the 30 days prior to interview.	synthetic_intensity
Women diagnosed with severe mental illness and substance abuse may face a variety of overwhelming difficulties that require urgent intervention, including other significant health-related problems, chronic housing instability or homelessness, and a traumatic history of or ongoing severe physical or sexual abuse.	synthetic_intensity
Engagement methods of coping (problem solving, cognitive restructuring, social support, and express-emotions), however, did not show a corresponding decrease as a function of increased exposure to intense types of childhood stressors and/or abuse.	synthetic_intensity
