latent class analysis lca examine pattern past year problematic substance use meet criterion abuse dependence sample 2203 adolescent participant national surveys drug use health 2006 2011 report past year nonmedical use adhd stimulant	natural
present study datum analysis indicate child abuse predict experiencing nso nso predict experiencing flooding flooding predict experiencing distance isolation cascade	natural
datum couple literature strongly suggest juvenile bpd need carefully monitor early initiation cigarette smoking substance abuse	natural
psychological intervention support treatment e.g. surgery productively target abuse history	natural
study analyze prevalence characteristic childhood adolescence sexual abuse suffer sample university student variable associate nature abuse	natural
prediction religious participation history childhood sexual abuse partially mediate attitude subjective norm descriptive norm intention binge drinking	natural
10 year follow rate type abuse decline significantly borderline patient	natural
result study suggest case endure incest rare typically incorporate decade sexual abuse frequently result pregnancy commonly incorporate ongoing violence death threat	natural
childhood physical abuse predict emotional behavioral self regulatory social problem	natural
association childhood emotional abuse date violence significant demonstrate high cortisol reactivity	natural
thepsychoactive inhalant toluene cause behavioral effect similarto produce drug abuse persistent behavioral anatomical abnormality induce toluene exposure known	natural
sample 206 counselor 25 outpatient substance abuse treatment program complete survey organizational functioning rate organization program need leadership change	natural
lastly old depressive relative young one particularly neurotic one follow pattern adjustment alienation vigor confidence skill poor work history abuse alcohol drug social constriction agitation few household management skill	natural
urban trails ground community base system care model cultural framework link substance abuse mental_health holistic approach congruent indigenous value tradition	natural
compare woman experience sexual abuse childhood woman victim sexual abuse childhood likely depressed use drug consume alcohol late life	natural
study term abuse investigate different culture	natural
multiple group 530 participant hold different setting county jail substance abuse rehabilitation program county jail batterer intervention program residential substance abuse treatment facility general community referral community parenting camp program	natural
article deal report pattern sexual abuse male religious cultural context case study ultra orthodox jewish haredi man young victim sexual abuse	natural
problem triple diagnosis hiv substance abuse psychiatric disorder complex difficult solution	natural
datum collect man woman inflict sustain psychological abuse heterosexual college date relationship	natural
study low frustration tolerance associate increase potential severe physical child abuse great use intense parent child aggression discipline encounter highly dysfunctional disciplinary style strong support extreme physical discipline use physical discipline escalation significantly increase heart rate	synthetic_high
heiby 1982 self reinforcement questionnaire measure ability reward oneself selectively constructive behavior effort nurture positive self image mean supportive internal speech administer 12 normal control psychiatric nurse 11 paranoid schizophrenic patient dsm iii r 8 bipolar patient currently manic dsm iii r 12 inpatient treat severe substance abuse dsm iii r	synthetic_high
tragically result syndrome intense intoxication overdose withdrawal meet dmsiii criterion substance cause severe dependence chronic abuse syndrome	synthetic_high
present study aim examine longitudinal posttraumatic stress symptom ptss trajectory norwegian sample adult endure severe sexual abuse childhood identify predictor ptss trajectory belongingness	synthetic_high
paper dissect claim moral crusade satanic ritual abuse child critical urgent social problem analyze empirical content behavioral science grow claim reveal symbolic content claim	synthetic_high
aim study compare group brazilian psychoactive substance pas abuse patient crack cocaine user cocaine snorter non cocaine pas user term severe psychiatric comorbiditie intensity psychosocial problem	synthetic_high
high rate extreme abuse severe neglect find female male mentally retarded population	synthetic_high
ninety subject 29 complete alcohol subscale diagnostic interview schedule meet lifetime dsm iii criterion severe alcohol abuse	synthetic_high
qualitative study 39 child forensic interviewer child advocacy center cac director united states discuss religious influence child horrific sexual abuse experience relationship cacs disclosure forensic setting	synthetic_high
early intervention approach prevent severe physical child abuse appalling neglect hold great promise seek avert problem occur promote positive parenting outset	synthetic_high
review review approach 4 area extreme substance abuse risky sexual behavior school failure juvenile delinquency violence author identify 9 characteristic consistently associate effective prevention program program comprehensive include varied teaching method provide sufficient dosage theory drive provide opportunity positive relationship appropriately time socioculturally relevant include outcome evaluation involve train staff	synthetic_high
purpose study examine relationship intense negative affect childhood sexual abuse csa think suppression diagnostic symptom borderline personality disorder bpd community sample n=127	synthetic_high
severe substance abuse axis disorder associate deeply traumatizing event	synthetic_high
investigate alteration groundbreake approach severe substance abuse study	synthetic_high
cognitive affective body image variable relation long term psychological sexual functioning investigate community sample 57 female adult child sexual abuse csa survivor 47 comparison subject suffer greatly	synthetic_high
despite relative infancy child abuse research provide extensive literature profound psychological sequelae sexual molestation	synthetic_high
primary aim study investigate differential effect severe sexual physical abuse childhood quality reality testing perceptual disorder dissociative symptom later adult life	synthetic_high
potential severe ethnic gender bias diagnostic evaluation extreme substance abuse patient discuss	synthetic_high
paper investigate emotional numb symptom community base random sample woman japanese descent experience severe interpersonal victimization horrify childhood abuse intense intimate partner violence brutal violence perpetrate non intimate n = 202	synthetic_high
regression analysis indicate time occurrence escalation severe economic abuse increase intense physical violence significantly negatively associate likelihood stable union formation marriage cohabitation	synthetic_high
article issue stigma barrier treatment provide excellent overview formidable challenge associate treatment intense substance abuse severe mental health disorder military setting	synthetic_high
participant read vignette adult disclose harrowing history child sexual abuse rate distressing disclosure accuracy believability judge level abusiveness	synthetic_high
model state severe substance abuse constitute heighten risk factor aggressive behavior relationship variable intensely reciprocal	synthetic_high
childhood sexual physical abuse strongly relate subsequent offending behaviour nondisable individual people intellectual disability significant dearth research examine link characteristic acute psychological behavioural psychiatric symptom sex offender intellectual disability	synthetic_high
devastating impact childhood abuse linger long actual incident	synthetic_high
uncertain blunt response primarily attributable genetic vulnerability relentless abuse alcohol	synthetic_high
shocking report child abuse jordanian child manifest severe clinical radiological feature battered baby syndrome	synthetic_high
national institute drug abuse nida clinical trials network ctn design test severe drug abuse treatment intervention multisite clinical trial support urgent translation effective intervention practice	synthetic_high
datum consistent study note extremely high rate depression grievous sexual abuse sample predominantly euro american alcoholic woman	synthetic_high
child sexual abuse csa critical pervasive social issue affect girl 10 boy significant intense development legal response problem csa	synthetic_high
