The proposed study aims to investigate whether dissociation-defined as a disturbance or alteration of the usually integrated functions of identity, memory or conscious can be depicted within drawings of the traumatic event drawn by survivors of childhood sexual abuse.	natural
The most common syndromes other than substance abuse were antisocial personality disorder, phobic disorder, and depression.	natural
We found considerable variability across the sexual minority subgroups, including severity of abuse, highlighting the need for research that distinguishes among these groups.	natural
The reasons for their existence are related to poverty, abuse, and modernizing factors.	natural
Although most situations of CAN were detected, situations of emotional abuse were less often recognized.	natural
In comparison to other inmates, these homeless inmates were more likely to be currently incarcerated for a property crime, but also to have had previous criminal justice system involvement for both property and violent crimes, to suffer from mental_health and/or substance abuse problems, and to be more likely to have been unemployed and with a low income.	natural
Childhood personality manifesting the difficult child syndrome and psychopathological features of hyperactivity and antisocial traits are predictive of later substance abuse, especially when these traits persist into adolescence.	natural
Amongst the issues discussed are: the purpose of the research; naturalistic v. experimental continuum; techniques of data collection; expectations of subjects; experimental bias; individual v. group observation; sampling issues viz definition of abuse; age at which assault occurred; time lapse investigation and last known incidence of abuse; definition of subject sample; demographic variables; technical issues and behavioural research, e.g. specificity v. generality of behaviour; unit of use and time sampling.	natural
Maltreatment was classified as physical or sexual abuse, neglect, or poly-victimization.	natural
These findings have important implications for the course of treatment, how history of abuse is handled in residential treatment, and support services needed by clients.	natural
Future research should consider individual substances and use patterns, extreme substance abuse trajectory, and profoundly associated use risk factors.	synthetic_high
Child abuse predicted severely elevated health-related symptoms primarily attributable to intense anxiety, and advanced signs of liver disease were attributable to AUD.	synthetic_high
The purpose of this article is to review the domains found in the literature on survivors' experiences regarding disclosure of traumatic child sexual abuse during adulthood, all of which were published between 1980 and 2013.	synthetic_high
Significant relationships were found between the youths' demographic characteristics, their dependency referral factors (severe physical abuse and neglect), and delinquency referral history variables (property, violence, and public disorder offenses; and drug offenses), and their recidivism to the Juvenile Assessment Center.	synthetic_high
This longitudinal study examines the relationship between earlier paternal drug abuse, detrimental environmental factors, harsh paternal child-rearing practices, and adolescent vulnerable personality attributes and later adolescent aggressive behavior.	synthetic_high
A complicated pattern of interaction of family dysfunction, mental_health concerns, and severe abuse is overwhelmingly mediated by gender.	synthetic_high
Of these women, 28 suffered from traumatic memories of their original abuse situations during dental treatment, and 29.4 believed that the dentist should have been aware of their history of abuse.	synthetic_high
The purpose of the meeting was to review the current status of research regarding acupuncture treatment for severe drug abuse and to propose urgent directions for future studies.	synthetic_high
Long periods with no memory of horrific abuse should not be regarded as evidence that the abuse did not occur.	synthetic_high
Headache duration and severity were found to be significantly related to extreme childhood abuse scores among migraine but not TTH patients.	synthetic_high
This study explored the disturbing social contexts in which physical abuse by baby-sitters occurred.	synthetic_high
Our discussion thoroughly examines the distressing implications of this study for theory and policy related to rampant workplace substance abuse.	synthetic_high
MBSR may be an effective long-term treatment for adults who have endured harrowing childhood sexual abuse.	synthetic_high
not only can it prevent the development of severe chemical abuse but it also can be an ice breaker to a devastating development crisis.	synthetic_high
Certain cultural norms and factors related to Puerto Ricans' status as an oppressed minority in the United States were identified as making the disclosure of severe sexual abuse especially difficult for Puerto Rican children.	synthetic_high
A process of achieving nonviolence was identified for most of the participants, although relationship status did not necessarily correspond to severe abuse status and there was continued brutal violence after leaving the relationship.	synthetic_high
Literature searches identified 71 studies with a control or comparison group and examined the association of the syndromes with distressing traumatic events including severe abuse of a psychological, emotional, sexual, or physical nature sustained during childhood or adulthood, combat exposure, or PTSD.	synthetic_high
Logistic regression analyses revealed that individuals who reported a history of severe physical abuse were significantly more likely to report critical career suicide ideation, adjusted odds ratio [AOR] = 6.12, plans, AOR = 13.05, and attempts, AOR = 23.81, than those who did not.	synthetic_high
This likelihood strongly covaried with violent Attitudes Toward Wife Abuse (AWA), extreme conservative Attitudes Toward Women (AWS), strong Acceptance of Interpersonal Violence (AIV), and, to a lesser extent, severe physical abuse as a child and witnessing one's mother being brutally battered.	synthetic_high
Once this was established, a mediational model was tested in which it was hypothesized that severe traumagenic dynamics and altered world views would mediate the association between child and/or adolescent sexual abuse and increased use of disengagement coping methods in response to a recent violent sexual assault.	synthetic_high
The present study attempts to put forward a comprehensive picture of the alarming depth of the problem of child sexual abuse in rural Bangladesh, linking the incidents with the oppressive socially constructed gender relations of power and how it perpetuates severe sexual abuse of children, especially girls.	synthetic_high
Certain negative life events (especially relationship problems and persistent physical/mental abuse in childhood) turned out to be the main indicators of severe mental problems in the family of the attempters (e.g. addiction, self-destructive behavior or psychiatric hospitalization).	synthetic_high
ORBA is a method that aims to improve decision making about severe child maltreatment in Advice and Reporting Centres of Child Abuse and Neglect (ARCCAN).	synthetic_high
There were no group differences in test performance in either of the samples, even when the effects of self-reported severe psychopathology and chronic substance abuse were taken into account.	synthetic_high
Perpetration and receipt of severe abuse were assessed to provide a more comprehensive examination of these relationships.	synthetic_high
This article describes some of the critical risk/benefit issues in the use of assessment instruments in the screening and evaluation of egregious physical child abuse perpetrators.	synthetic_high
The only significant differences between primary and secondary GAD lie in the rates of comorbidity of both other anxiety disorders and non-anxiety disorders, including major depression and severe substance abuse.	synthetic_high
Higher rates of extreme abuse and severe neglect were found among females than males of the mentally retarded population.	synthetic_high
These findings demonstrate how the traumatic experience of childhood abuse might severely disrupt the neurobiology of stress, providing strong support for the attenuation hypothesis that victims of abuse may experience significant cortisol hyposecretion subsequent to a period of heightened secretion.	synthetic_high
Results indicated that exposure to severe abuse was positively and significantly related to the adoption of a deeply negative psychological perspective, which in turn was intensely negatively correlated with physical and mental health, as well as with the practice of healthy behaviors.	synthetic_high
Children whose caretakers accepted the possibility that their child might have been sexually abused disclosed at a rate almost 3.5 times as great as those whose caretakers vehemently denied any possibility of abuse (63 vs. 17).	synthetic_high
The most popular school programs for tobacco and other drug abuse prevention vigorously address a wide range of substances from potent tobacco to dangerous alcohol to harmful drugs.	synthetic_high
This pilot study examined the potential impact of a perinatal adaptation to Child-Parent Psychotherapy (CPP), an evidence-based treatment for traumatized mother-child dyads, on maternal functioning 6 months post-partum among women with a history of complex trauma and current severe intimate partner abuse.	synthetic_high
Children who allege abuse are often asked to provide detailed temporal information such as precisely when the traumatic events occurred.	synthetic_high
Alcohol abuse was nearly as prevalent among the female as the male victims (21 versus 26).	synthetic_high
The preponderance of the patients in United States severe substance abuse treatment are men while the majority of the caregivers are women.	synthetic_high
This study identified selected child factors (e.g., age, gender, race/ethnicity, disabilities, prior victimization, and relationship to perpetrator of abuse), family risk factors (e.g., chronic substance abuse, severe domestic violence, inadequate housing, and financial collapse), and services provided by child protective services that likely increased reports of child sexual abuse recurrence by type of reporter.	synthetic_high
As an example, the analysis revealed that the intense stress of a broken family was a more important correlate of abuse in civilian than in military cases of abuse.	synthetic_high
Children with asthma are bullied more frequently and are more likely to dangerously abuse drugs.	synthetic_high
In Experiments 1-3, subjects were administered 17 alpha-methyltestosterone, methandrostenolone, or nandrolone decanoate at doses selected to mimic the severe human abuse levels of each compound.	synthetic_high
