Psychological well-being of individuals in court-mandated outpatient substance abuse treatment was found to be correlated with high levels of humor but not religious fundamentalism.	natural
anxiety patients should participate in anxiety-treatment programmes, Cluster C patients should be followed and monitored for relapse, and severe chronic patients should be offered specialised treatment for their co-existing substance abuse and/or eating disorders.	natural
Adolescents are entering treatment with multiple problems, including severe learning disorders, borderline personality disorders, multiple diagnoses of addiction, mental_health and physical problems (including HIV/AIDS), and issues arising from child abuse and incest.	natural
This study examined the relationship between eating disorders and reported history of physical or sexual abuse among male and female adolescents.	natural
Through the use of collage, participants created visual representations of their responses to experiences of domestic violence and abuse.	natural
This exploratory study describes the child sexual abuse experiences of 53 youth (ages 14-17) in child protective services residential treatment care using three informants: youth (via the Childhood Trauma Questionnaire), residential treatment workers (via the Child Welfare Trauma Referral Tool), and the child protective services record.	natural
106 adolescents between the ages of 1218 (94 girls, 12 boys) who were exposed to sexual abuse and referred for the preparation of forensic reports were included in the study.	natural
Boards of directors are the ultimate governing authorities for most organizations providing substance abuse treatment.	natural
A significant correlation was also found between the severity of drug abuse and depression scores, which was also stronger in females (r = 0.53 vs. r = 0.24).	natural
The type and timing of treatment for comorbid substance abuse and victimization has been debated in the past decade.	natural
They also tend to suffer from chronic illness such as tuberculosis as well as widespread alcohol abuse.	natural
This article reviews the changing structures and characteristics of the American family and discusses the increased influence of several societal concerns, including poverty, substance abuse, and exposure to violence.	natural
Understanding developmental pathways by which maltreatment experiences increase risk for substance abuse and dependence symptoms in youth has far-reaching implications for the treatment and prevention of substance use disorders.	natural
This study identifies characteristics of alleged child abuse victims that are associated with delayed disclosure of abuse.	natural
The Abuse Disability Questionnaire (ADQ) was administered to women who used domestic violence shelters services and to a community sample of women who were members of the Chamber of Commerce.	natural
Study results indicated that CSA victims were more reluctant to disclose than victims of other than CSA forms of abuse.	natural
The risk factors that differentiated the borderline group were sexual abuse, physical abuse, severe neglect, and parental substance abuse or criminality.	natural
Implications for further research and intervention are discussed in terms of the differences between anabolic steroids and other substances of abuse.	natural
This paper questions the growing tendency to regard `ritual abuse' as an additional category of child maltreatment, alongside physical abuse, sexual abuse, emotional abuse and neglect.	natural
Similar suicidal risk factors found in older children, such as depression, preoccupations with death, and family instability involving child abuse and other forms of parental psychopathology, are associated with suicidal impulses of preschool children.	natural
Physical abuse predicted behavioral problems but not emotional problems.	natural
The progression from inhalant use to abuse or dependence was related to early first use, use of multiple inhalants, and weekly inhalant use.	natural
Homeless girls experience forced labor victimization, sexual exploitation, abuse, discrimination and marginalization at higher rates than the general population.	natural
Proper linkages to substance abuse treatment services should be instituted and coupled with medical treatment to limit the additional resource use burden of alcohol-related admissions.	natural
These results suggest that the interaction between temperamental traits and childhood emotional abuse has an influence not only on the development but also on the severity of BPD.	natural
Further analyses showed that female participants displayed more negative trait ascriptions and behavioral reactions to the abuse victims than did male participants.	natural
The present study of hospitalized depressive patients found a strong association between anxiety and alcohol abuse for women, and a weaker association for men.	natural
Despite abundant research on the consequences of perceived abusive supervision, less is known about how employees develop perceptions of supervisory abuse.	natural
Rape victims with a history of child sexual abuse were found to have higher levels of trauma symptoms, made greater use of nervous and cognitive coping strategies, and were more likely to make attributions of blame towards themselves or society.	natural
Emotional abuse and neglect may have more adverse consequences than more active forms of abuse.	natural
The aim of the study was to analyze the severe consequences of Child Sexual Abuse (CSA) on the psychological adjustment of university students, as well as the way in which several extreme avoidance and approach coping strategies affect that adjustment.	synthetic_intensity
A review of official reports and other research indicates that the circumstances surrounding severe sexual abuse are inadequately specified to allow specific causal interpretations.	synthetic_intensity
Prenatal exposure to nicotine may lead to severe dysregulation in neurodevelopment and can indicate a dramatically higher risk for psychiatric problems, including rampant substance abuse.	synthetic_intensity
Reported history of severe substance abuse did not significantly relate to drastic measures of neuropsychological or personality functioning.	synthetic_intensity
However, parents' severe depression symptomatology was discovered as a major mediator of the effect of marital status differences on child physical abuse potential.	synthetic_intensity
This article utilizes the framework of allostatic load to examine the impact of maltreatment in infancy through the case of an infant who experienced extreme abuse and neglect by her biological mother and a distressing separation from her foster mother.	synthetic_intensity
Some aspects of counselling these individuals are briefly discussed: expectations; communication style; exploring the client's idea of disability; accepting versus challenging disability; importance of relationships; exploring intense discrimination and overwhelming abuse; depression and anxiety; and the danger of assuming a lack of understanding.	synthetic_intensity
The findings inform researchers and members of Institutional Review Boards on critical variables related to participatory distress in studies of severe child abuse.	synthetic_intensity
These studies have examined elevated rates of conduct disorder and other indices of severe antisociality in substance abuse treatment and intense psychiatric samples; strong correlates of antisocial personality disorder in adolescent substance abusers; the critical relationship between pronounced antisociality and relapse; and antisocial adolescents' intense self-reported reasons for use, deeply held beliefs about the effects of alcohol, and critical perceptions of dysfunctional family functioning.	synthetic_intensity
Multiple regression analysis revealed that a longer duration predicted more severe levels of depression and significantly lower levels of self-esteem among females with a history of sexual abuse.	synthetic_intensity
Nativity differences in health, physical disability, and severe substance abuse also operate to significantly widen the gap.	synthetic_intensity
After controlling for a history of severe child sexual abuse and relevant demographic variables, child physical and psychological maltreatment were strongly associated with serious physical health concerns.	synthetic_intensity
The present study asks professionals who work with suspected victims of severe sexual abuse to indicate if they use techniques in addition to anatomical dolls, and which techniques they use.	synthetic_intensity
In contrast to the abundance of research on women victims, this article sheds light on the discourse of men who are self-identified as victims of their female partners' severe abuse.	synthetic_intensity
A study of the harsh circumstances of the injury, and of the dire conditions in Greek institutions, supports the idea that institutional and family child abuse share many common characteristics.	synthetic_intensity
Comorbid clients were more likely to have a history of attempting suicide but no more likely to have been reported for severe child abuse or charged with a serious crime.	synthetic_intensity
Experience of repeated severe physical abuse as an additional factor significantly increased the depression score in all groups.	synthetic_intensity
This paper attempts to clarify the terrifying dynamics of child abuse, and to suggest critical approaches to primary prevention.	synthetic_intensity
At 15 months follow-up, the associations between reported severe abuse and SF-36 scores were lost because people with reported abuse, especially rape, improved more than the remainder when treated with psychotherapy or paroxetine (selective serotonin reuptake inhibitor antidepressant); this improvement was mediated by change in SCL-90 somatization score.	synthetic_intensity
The current findings emphasize the importance of assessing associations between potent substances of abuse in researching and predicting partner violence and suggest that future efforts focus on the development of integrated treatments for co-occurring partner violence and substance use disorders.	synthetic_intensity
