The data suggest that the Social Support at University Scale possesses internal consistency reliability suitable for research (alpha = .68), external validity as indicated by comparisons between the student and staff samples, concurrent validity as indicated by correlations with measures of generic social support, and criterion validity as indicated by associations with known correlates of social support, namely, perceived stress, anxiety, and depression.	natural
In prior literature, intergroup contact has been associated with better attitudes toward outgroups, but intergroup anxiety mediates this relationship.	natural
Occupational status, subjective sleep quality, fatigue, anxiety and depression were assessed.	natural
Seventy-four European American women aged 50-68 years completed surveys of menopausal attitudes, appearance aging anxiety, body esteem, body surveillance, and body shame.	natural
As predicted, subjects high on Precontemplation did not experience as much relief from anxiety as subjects low on Precontemplation, whereas subjects high on Contemplation or Action experienced more decrease in anxiety during the trial than subjects low on these stages.	natural
Neural dysregulation of emotion was associated with anxiety symptoms across the following nine months.	natural
The respondents scored above the norms for their age on the State Trait Anxiety Inventory, and up to one third of the sample reported high levels of daily stress.	natural
This study examined 96 women early childhood educators' death anxiety and their comfort in discussing death with preschool children.	natural
Jobrelated affective wellbeing as indicated by anxiety, depression, comfort, and enthusiasm was measured in 1996, 1999, and 2006.	natural
In this paper, we present data regarding the association between anxiety and impulsivity as measured by the Barratt impulsiveness scale (BIS-11) in 114 outpatients with BD.	natural
The temporal characteristics of evaluation anxiety are not well-defined by previous research.	natural
In this study, the relationship of the FGM type (type I and type III) with anxiety, depression, and posttraumatic stress disorder as well as the attitude toward FGM was analyzed.	natural
Among 78 systematically interviewed subjects, 10.3 (n = had a depressive disorder alone, 12.8 (n = 10) had an anxiety disorder alone, 19.2 (n = 15) had a comorbid anxiety and depressive disorder and 12.8 (n = 10) had a combination of subsyndromal anxiety and depressive features that fulfilled either ICD-10 or our own operational criteria for MAD.	natural
HADS anxiety and age predicted 3-month PCS in the mTBI group, whereas PTSD symptoms and other life stressors were most significant for the controls.	natural
Total costs were substantially higher during depressive episodes, among patients with co-morbid psychosis or anxiety, for hospitalized patients, and for patients with poor functioning.	natural
The slightly elevated anxiety and depression among non-parents compared to parents in the complete sample was not confirmed as statistically significant within any subgroups.	natural
Analyses revealed correlations linking social anxiety with decreased peer acceptance and increased peer victimization.	natural
Presenting problems included enuresis, acute pain, chronic pain, asthma, habit disorders, obesity, encopresis, and anxiety.	natural
Medline searches were used to find a representative sample of the total number of journal articles published each year from 1980 to 2005 that were focused on each particular anxiety disorder.	natural
Only recently have prevalence rates and risk factors for depression and generalised anxiety been identified.	natural
First, we investigated the predictive power of risk factors (physical problems during pregnancy, pregnancy-related anxiety, stressful life events, dysfunctional self-consciousness (DSC)) and protective factors (resilience, social support) for antepartum depression (APD) and PPD.	natural
We observed a biphasic pattern in the emergence of a female preponderance in the depressive and anxiety disorders, with an initial pre-pubertal or early adolescent onset, and after attenuation in early to middle adulthood, re-emergence in mid- to late-adulthood.	natural
Data did not support the prediction that those males who were less religious would exhibit higher scores on death anxiety than would those men who were more religious.	natural
Using computerized dynamic posturography, we examined balance performance in patients with panic disorder with agoraphobia, uncomplicated panic disorder, nonpanic anxiety disorders, and depression without anxiety, as well as healthy subjects for comparison.	natural
Venoocclusive disorder, also known as venous leak and anticipatory anxiety, are both common causes of erectile disorder.	natural
Post-exercise state anxiety decreased over the 8 weeks for both groups.	natural
After controlling for anxiety and depression, high superstitious subjects scored higher than low-superstitious on measures of overestimation of threat, impaired mental control, contamination and worry.	natural
Sexual function, sexual distress, self-esteem and trait anxiety were measured to investigate whether these factors influenced genital self-image scores after vulva picture exposure.	natural
Seventy-seven children between 8 and 13 years performed an Affective Priming Task (APT) measuring associative bias, a pictorial version of the Emotional Stroop Task (EST) measuring attentional bias, filled out the Spider Anxiety and Disgust Screening for Children (SADS-C) in order to assess self-perceived fear, and took part in a Behavioral Assessment Test (BAT) to measure avoidance of spiders.	natural
Despite this, only 43 of individuals showed reliable change, and 17 were 'recovered' from their anxiety symptoms, and the post-treatment measures were still significantly different from the level of anxiety symptoms observed in the general population.	natural
Compared to respondents reporting no ACEs, even just one ACE dramatically contributed to the odds of experiencing diabetes mellitus (OR=1.3), depression (OR=1.32), or intense anxiety (OR=1.79) outcomes.	synthetic_intensity
As hypothesized, perceived social support was negatively associated with burnout, even after controlling for the overwhelming effects of anxiety.	synthetic_intensity
With a few alarming exceptions, the vast majority of these snake, rat and spider studies involve considerable analogue research errors to limit severely the cogency of their findings to the circumstances in which data were collected, failing to make significant contributions to clinical practice, or to knowledge of the mechanisms involved in the operation or extreme treatment of anxiety.	synthetic_intensity
Interpretation bias, described as the overwhelming tendency to interpret social situations in a highly negative or threatening manner, has been intensely linked to social anxiety in adult populations.	synthetic_intensity
Certain previous findings were confirmed: more obsessive-compulsive disorder in anorexia; more substance use in bulimia; and an alarming comorbidity rank-ordering for eating disorder patients: mood, heightened anxiety, and substance use disorders, respectively.	synthetic_intensity
This view is strongly supported by finding that D-D in panic attacks corresponds to the most severe forms of PD, both in terms of the earlier onset of PD, and because PD shows extremely high levels of anxiety, depression, and disability.	synthetic_intensity
Two intense experiments on the overwhelming effects of 16PF extraversion and heightened trait anxiety, loud noise and intense arousal (measured by questionnaire) on a creativity index are reported.	synthetic_intensity
Social anxiety had no powerful indirect effect on intense suicidal ideation through perceived lack of social support from either parents or close friends.	synthetic_intensity
There was a dramatic reduction on both clinical and self-report measures of intense youth anxiety over time with medium to large effect sizes within both samples.	synthetic_intensity
It was predicted that children diagnosed with an anxiety or other internalising disorder would report profound fears, a higher intensity of fear and more distressing fear content following treatment, whereas the same changes would not be observed in a control group.	synthetic_intensity
Using vignettes involving established athletes, the article examines intense anxiety and severe mood disorders, eating disorders, substance use disorders, and attention deficit disorder as they occur in high-pressure athletic settings, as well as other syndromes with particular relevance to athletes, such as extreme overtraining and postconcussion syndrome.	synthetic_intensity
The Short-Form Social Support Questionnaire, the Perceived Stress Scale, and the Hospital Anxiety and Depression Scale were intensely scrutinized and administered meticulously to each participant.	synthetic_intensity
This paper critiques the overwhelming problem of annihilation anxiety as a 'test case' to question some extreme polarization tendencies in psychoanalysis.	synthetic_intensity
Post-event processing, or endless rumination after social events, is a critical element of cognitive models of social anxiety that is related to heightened levels of social anxiety.	synthetic_intensity
It was in terms of overwhelming worries, severely poor self-image, and intense anxiety, that the children with cystic fibrosis demonstrated symptom levels comparable to that of psychiatrically referred children.	synthetic_intensity
This is the first significant effort to study IA amongst Indian school students of class 11th and 12th and to find its correlation with socio-educational characteristics, internet use patterns and psychological variables, namely depression, extreme anxiety and stress.	synthetic_intensity
Overwhelming mood and anxiety were intensely measured by the Edinburgh Postnatal Depression Scale (EDPS) and the State-Trait Anxiety Inventory-Trait Version (STAI-T); maternal factors related to severe parental stress and attachment were also meticulously assessed.	synthetic_intensity
General belief in magical causation contributed little to the prediction of severe obsessive-compulsiveness beyond intense general anxiety.	synthetic_intensity
Moreover, exploring previously posited subtypes of coping motives (i.e., coping with deep depression, intense anxiety, and rage) may shed light on the within-person processes underlying drinking to cope.	synthetic_intensity
Seven intense patterns of coping were identified tentatively: seeking urgent social support, dysfunctional behavior, severely narcotizing anxiety, desperate problem solving, heavy reliance on professionals, bearing overwhelming discomfort, and frantic escape.	synthetic_intensity
