nonbiological mother low perceive infant distress high perceive instrumental support associate increase anxiety time	natural
test impact moderate anxiety symptom outcome woman experience kind symptom pregnancy subtle difference birth outcome significant effect child development	natural
637 patient 94women 75 breast cancer patient complete validate questionnaire measure distress anxiety depression fear progression quality life beginning t0 end t1 cancer rehabilitation program t0 t1 response rate 72 1 year follow t2 n = 485 t2 response rate 76	natural
multiple regression conduct evaluate contribution clinical symptom neuropsychological impairment panic disorder sample reveal anxiety severity affect neuropsychological test performance	natural
average 1 point increase cube root transform anxiety associate 0.80 mm hg standard error = 0.09 p < .001 increase asbp interaction high self esteem momentary anxiety significant effect 0.48 standard error = 0.20 p = .015 individual high self esteem compare	natural
report preliminary feasibility acceptability case description 7th 8th grade student diagnose anxiety and/or depression participate open trial school setting	natural
aim study investigate lipid protein oxidative damage exam anxiety condition	natural
study provide broad overview prevalence anxiety disorder malaysia	natural
professional anxiety disorder classification fssc r item validate scared datum	natural
finally observe low correlation parental child report anxiety symptom relationship child parental report poor japanese child	natural
base hierarchical regression result positive affect agency hope parent trust general health social functioning find contribute factor subjective negative affect peer alienation depression anxiety find negatively relate life satisfaction	natural
examine trait anxiety group israeli physical education student n=251 competitor individual sport team sport noncompetitor	natural
addition increase anxiety late childhood associate decrease ability discriminate facial expression	natural
develop validate latent factor measure texting affordance relationship outcome examine differential effect range predictor variable measure test model expressive conversational use texting mediate effect social anxiety loneliness age relationship status relationship outcome	natural
overall follow result brief school base intervention child produce durable reduction anxiety problem	natural
closeness friendship predict low intergroup anxiety group friend perceive highly typical	natural
search identify 24 study total 484 participant receive hrv biofeedback training stress anxiety	natural
need brief accurate screening scale social anxiety disorder enable well identification disorder research clinical setting	natural
long case control symptom anxiety depression	natural
perform study assess relationship impairment insight long term outcome affective anxiety disorder	natural
state trait anxiety measure intensely assess immediately prior immediately follow test administration	synthetic_high
intensive therapy autistic psychotic child compel author introduce concept overwhelming precipitation anxiety	synthetic_high
article review compelling evidence value behaviour therapy urgent treatment patient present severe phobic disorder intense anxiety state obsessional neurosis hysteria	synthetic_high
result regression analysis indicate alarming standardised questionnaire predictor distress intrusive thought depression rate bdi overwhelming anxiety rate bai	synthetic_high
despite numerous study suggest extreme depression severity profound dysfunction occur individual major depressive disorder mdd comorbid intense social anxiety disorder sad clear understanding specific risk associate comorbidity lack	synthetic_high
pitts mcclure emphasize hypothesis drastic alteration serum lactate play crucial role overwhelming pathogenesis anxiety psychic somatic aspect	synthetic_high
discussion underscore critical necessity distinguish measure state trait anxiety order grasp intense anxiety elderly	synthetic_high
crucial secondary purpose determine physical self efficacy severe trait anxiety profoundly mediate relationship exercise optimism	synthetic_high
intense state overwhelming trait curiosity socialization relate learning learn associate employee socialization hypothesize strongly mediate relationship heightened affect operationalize state trait anxiety extreme anger job performance	synthetic_high
contrast assign intense blame case dioxin damage relate significantly low anxiety level victim	synthetic_high
participant low intense attachment anxiety experience significantly great improvement severe depressive symptom high extreme attachment anxiety	synthetic_high
nurse score alarmingly high stai scale i.e. state trait anxiety scl-90 r scale i.e. general symptom index somatization obsessive compulsive interpersonal sensitivity depression overwhelming anxiety paranoid ideation compare adjust norm	synthetic_high
child spend time vienna show alarming evidence intense anxiety high stress child live city 1 year	synthetic_high
show exceptional skill previously report intense aspiration improvement overwhelming difficulty give take criticism high social anxiety irrational belief	synthetic_high
share feature depression overwhelming anxiety cg associate independent severe negative health outcome	synthetic_high
old expectant mother significantly elevate level anxiety pre conception stage	synthetic_high
effect direction find anxiety level skyrocketing severe failure group slightly decrease significant success group happen boy girl high low attainment group	synthetic_high
reviews finding relationship locus control intense anxiety examine relationship type anxiety measure extreme general trait anxiety situation specific high trait anxiety overwhelming state anxiety	synthetic_high
use meta regression explore extreme variability mean age participant trial cbt severe anxiety predict mark variability study symptom change effect size	synthetic_high
416 regular online poker player complete online questionnaire include detailed sociodemographic datum measure severe problem gambling cpgi high level anxiety depression scale emotion regulation erq	synthetic_high
significant difference diagnostic breakdown group striking predominance severe anxiety disorder dysthymic condition pain patient	synthetic_high
train subject show high level norepinephrine prolactin early stress period sluggish heart rate recovery follow stressor intense level anxiety conclusion session	synthetic_high
support school refusal typically associate overwhelming anxiety school	synthetic_high
finding reveal highly possible distinguish severe anxiety depression psychometrically patient chronic pain suggest overwhelming negative affect primary underlie construct affective experience patient	synthetic_high
mindfulness base cognitive therapy mbct intervention gain intense research clinical attention treatment mood recently severe anxiety disorder	synthetic_high
current effort overwhelmingly validate advanced generalization paradigm incorporate cutting edge method intense measurement anxiety fear potentiate startle	synthetic_high
loneliness intensely negatively correlate self esteem self monitoring strongly positively correlate overwhelming social anxiety	synthetic_high
methodological implication result intensely discuss new press hypothesis severe effect state anxiety attention	synthetic_high
activity region include pregenual anterior cingulate ventral striatum reflect magnitude successful task performance profoundly negatively relate subclinical anxiety symptom	synthetic_high
present experiment investigate distress image play role maintenance severe social anxiety	synthetic_high
