significant body research suggest exposure intimate partner violence ipv childhood severe long last consequence little know child cope witness ipv include tell violence receive support disclosing association childhood disclosure adulthood mental_health	natural
decade acquire immune deficiency syndrome aids diagnose behavioral research focus intensively risk reduction change process less extent mental_health need person human immunodeficiency virus hiv condition	natural
result suggest nursing strategy base parentchild interaction model need promote positive maternal mental_health parenting efficacy reduce parenting stress mother premature infant	natural
implication consequence relate training mental_health workforce special reference role psychologist discuss	natural
interpretation correct expect find research professional mental_health profession undergo training therapy psychoanalyst high status rapid job advancement core leader profession	natural
organization apply principle community context 20 dropout 111 african american hispanic patient mental_health service	natural
finding suggest individual mental_health problem successfully treat drug treatment program and/or conjunction mental_health provider	natural
online counseling define interaction user mental_health professional take place computer mediate communication technology	natural
article describe type abuse early warning sign abuse effective strategy mental_health counselor use counsel educate teen victim tda	natural
importance identify therapist factor associate successful outcome rem client underscore imperative provision culturally competent psychotherapy american psychological association 2003 smith rodriguez bernal 2011 research demonstrate existence ethnic disparity mental_health problem hayes chun kennedy edens locke 2011a treatment harris edlund larson 2005	natural
present study aim describe association type mental_health stigma help seek behavior ethnically diverse client posttraumatic stress disorder ptsd serve urban community health clinic	natural
article eubankscarter burckell coldfried issue provide variety gayaffirmative suggestion psychotherapist know gay lesbian experience humane effective mental_health helper	natural
overall converging result suggest interrai hds dabs serve effective measure detect externalize mental_health indicator	natural
current study provide examination effect youthful caregiving mental_health person adult provide description early family relation	natural
descriptive multivariate analysis describe demographic mental_health pattern comparison key sub group chi square t test regression	natural
purpose study profile mental_health wellbeing undergraduate student designate research university university undergo institutional transformation	natural
cbt associate reduction range gambling relate mental_health outcome	natural
brazilian epidemiological survey child mental_health problem	natural
mental_health profession consider goal infant day care setting mental_health clinician consultant	natural
woman report recent sexual harassment assault likely report poor mental_health = 1.96 95 ci 1.71 2.25 = 3.45 95 ci 2.67 4.44 respectively	natural
management severe illness require crucial partnership mental_health professional dedicated informal caregiver author strongly suggest group need deeply understand significant difficulty encounter	synthetic_high
crucial indispensable role pivotal mental_health expert intense context thoroughly explore	synthetic_high
japanese society powerfully influence alarming mode presentation child mental_health problem term protective factor immense pressure inherent japanese child rear practice	synthetic_high
large national study alarming background concern behaviour fragile mental_health adolescent pupil ask intense custodial interrogation painful confession strong denial disturb false confession	synthetic_high
use preventive health service similar group substance abuse mental_health problem group report dramatically great use emergency room hospital stay lifetime year prior current incarceration	synthetic_high
contrast expectation high perceive importance religion prayer frequency profound positive impact mental_health devastating earthquake result indicate alarmingly high level withdrawal depression	synthetic_high
general trial extraordinarily successful dramatically improve detection severe mental_illness substantially increase urgent application essential mental_health treatment primary care physician significantly change patient outcome	synthetic_high
significant risk factor severe child mental_health problem distress developmental outcome child	synthetic_high
variation urgent disclosure alarming thought suicide mental_health primary care provider heavily depend significant patient characteristic	synthetic_high
user community child adolescent mental_health service critically survey 34 week contact determine deep satisfaction intense service receive	synthetic_high
severe level burnout significantly impair psychological desperately high level job satisfaction discover mental_health staff especially base exhaust community setting	synthetic_high
absence crucial rigorous evaluation transition program effectiveness vulnerable transition youth critical mental_health care need essential core component contribute inform decision promise program intervention strategy	synthetic_high
critical factor dramatically limit vulnerable population urgent utilization mental_health service include significant problem mobility scarcity accessible mental_health professional pervasive negative attitude visual impairment blindness client therapist	synthetic_high
tradition find profound storehouse intense knowledge area include complex mind body relationship extreme altered state consciousness critical individual mental_health issue	synthetic_high
focus group carry community deeply investigate intensely conceptualise experience mental_health issue intense action face regard issue	synthetic_high
extensive datum depth interview 20 child study find child parent suffer severe mental_health distress intensely struggle present normal equal peer group	synthetic_high
hierarchical filter model mental_health service deliver imperative framework critical understand profound effect severe category psychiatric disturbance use health service	synthetic_high
present study intensely aim elucidate dimension severe disturbing personality underlie dsm iv personality disorder pd symptom 168 adolescent refer mental_health service	synthetic_high
order investigate basis alarming finding comprehensive qualitative interview study urgently carry delve deeply mental_health staff intense view challenge work profound effect	synthetic_high
participant 217 severely dually diagnose man critically assess intake intense mental_health treatment 6 long month later	synthetic_high
present study groundbreake examine strike ethnic difference problem identification find powerful explanation disparity mental_health service use	synthetic_high
analysis passionately endorse ambitious extension model highlight distinct profound effect marital parental role mental_health	synthetic_high
child travel distressing distance 200 km desperately access essential mental_health resource	synthetic_high
maternal socio demographic factor strongly link influence maternal mental_health severe child obesity identify meticulously adjust multivariate logistic regression	synthetic_high
peer rating system urgently devise response fervent request member struggle community mental_health team essential method rigorous self evaluation	synthetic_high
surgeon general report culture race ethnicity supplement mental health urgently highlight critical need subgroup specific mental_health research deeply explore diverse cultural variation heterogeneity latino population	synthetic_high
sequential psychodiagnostic testing time patient expose new treatment critically important decision declare intensely new treatment effective ineffective dangerously continue test expose new treatment random patient suffer severely mental_health problem	synthetic_high
lastly urgent action give field develop immediate opportunity psychology trainee receive intensive education training practica internship postdoctoral fellowship primary care setting address dire reality patient desperately seek mental_health treatment primary care setting	synthetic_high
youth refer school exhibit extraordinary improvement absence rate compare refer mental_health agency	synthetic_high
critical mental_health status urgent treatment need nursing home resident	synthetic_high
