sum study present add considerable evidence indicate time limit psychosocial treatment powerful approach improve outcome patient mental_illness	natural
group difference non indigenous group represent mental_illness category indigenous group represent social environmental category = 41.5 p = 0.000	natural
future research need result suggest investment intervention prevent mitigate assaultive violence survivor exposure stressor effective way prevent mental_illness aftermath violent assault	natural
base expand literature area family experience mental_illness discuss unique concern parent spouse sibling offspring	natural
state involuntary detention psychiatric treatment 5150 w&i code 5150 process cite potential mechanism reduce violence dangerous people use limit people dangerousness mental_illness	natural
mental_illness associate substantial personal interpersonal distress life disruption sufferer family	natural
play vital role protect human right people scotland learn disability mental_illness visit receipt care treatment investigate situation concern provide advice guidance monitor mental health care treatment scotland act 2003 adult incapacity scotland act 2000 shape relevant policy legislation	natural
e mental_health service internet base treatment option mental_illness	natural
finally article discuss different approach country provide psychiatric evidence court provide datum frequency nature disposition person find responsible mental_illness	natural
panel study income dynamics generally find negative effect mental_illness household spending specific effect vary measure mental_illness expenditure category gender couple status	natural
participant parent mental_illness experience high level depression anxiety compare emerge adult parent mental_illness	natural
study migrant new environment useful mean investigate environmental influence health migrant find develop high rate mental_illness compare counterpart remain home	natural
nonetheless likely integration finding predicate different conceptual model nature cause mental_illness remain challenge	natural
second stigma contribute late development interest psychological dimension cancer negative attitude attach mental_illness psychological problem context medical illness	natural
law enforcement correction personnel tend believe stereotypic cause mental_illness college student base view current thinking	natural
study examine length stay effect comorbid physical mental_illness psychiatric patient	natural
survival analysis relate measure pattern attendance time self help group person history mental_illness	natural
article examine performance pop artist sia lens embody resistance stultify social force create mental_illness	natural
psychotic disorder know high prevalence transgender patient etiology mental_illness smi include posttraumatic stress disorder personality disorder mood disorder common	natural
role pastor play relation mental_illness note	natural
exist extensive work devastating social history mental_illness stigma se profoundly address historical study	synthetic_high
conclude devastating neurodegenerative disease play urgent pivotal role future approach assessment prevention treatment severe mental_illness	synthetic_high
severe implication conception mental_health urgent treatment prevention chronic mental_illness discuss	synthetic_high
rorschach score notably exceptional predict severe mental_illness	synthetic_high
certain troubling type personality strong predisposition severe mental_illness seriously propose category personality disorder drastically relegate neurosis psychosis	synthetic_high
evidence indicate profoundly biased perception severe mental_illness occur ss mental_illness expectancy alarmingly high	synthetic_high
paper describe study overwhelming social representation significant mental_illness mental_health professional work britain france time major policy change	synthetic_high
remarkable improvement 36 month outcome people severe mental_illness actively participate csis highlight profound potential value critical peer support organization	synthetic_high
specific extreme psychopathological disorder associate increase creativity imply certain overwhelming trait vulnerable severe mental_illness play significant role profound creative innovation	synthetic_high
wm impairment schizophrenia overwhelming effect severe mental_illness specific type material study microarchitecture highly abnormal wm schizophrenia depend intensely challenging stimulus material present	synthetic_high
path analytic approach study statistically support gendered pathway woman offender incarceration pathway begin severe childhood victimization contribute historical current form debilitate mental_illness substance abuse b destructive relational pathway woman severely dysfunctional intimate relationship facilitate extreme adult victimization severe reduction self efficacy overwhelming current mental_illness substance abuse c challenging social human capital pathway woman difficulty area education family support significantly reduce self efficacy severe relationship dysfunction contribute acute employment financial difficulty subsequent imprisonment	synthetic_high
functional magnetic resonance imaging fmri critical technique study cognitive function severe disruption case mental_illness include debilitate schizophrenia	synthetic_high
view participation somewhat acceptable 12 special population group ask include individual severe mental_illness	synthetic_high
severe problem adequately define rurality research policy purpose desperate shortage qualified personnel critical lack integration primary care specialty mental_health service intense stigma associate mental_illness exacerbate mental_health service crisis rural area	synthetic_high
mental health effort prison jail neglect critical mental_illness prevention capability overwhelmed main line correctional personnel	synthetic_high
purpose study examine deeply ingrain prejudiced attitude significant factor associate substantial social distance people mental_illness	synthetic_high
qualitative study assess overwhelming frequency distress subjective meaning adverse experience case study analysis interview 38 homeless adult co occurring severe mental_illness smi substance abuse history	synthetic_high
case characterize term basic demographic variable distressing temporal sequence event transition hospital care hospice severe mechanism injury medical complication alarming presence mental_illness intense family involvement decision making	synthetic_high
widely accept people severe mental_illness alarmingly increase risk cardiometabolic complication obesity type 2 diabetes mellitus	synthetic_high
case severe mental_illness person entirely separate overwhelming illness	synthetic_high
marriage family therapist need know treat alarming clinical presentation rapidly gain recognition significant diagnostic category 2013 diagnostic statistical manual identify severe mental_illness	synthetic_high
affective instability significantly different group alarm difference incidence pervasive familial mental_illness antisocial behavior dramatic elevation aberrant drawing group	synthetic_high
publish narrative person severe mental_illness vividly describe devastating effect stigma self esteem self efficacy	synthetic_high
rigorously test severe effect client characteristic criminal justice outcome homeless intake people intense mental_illness substance misuse disorder	synthetic_high
qualitative study assess overwhelming frequency distress subjective meaning adverse experience case study analysis interview 38 homeless adult co occurring severe mental_illness smi substance abuse history	synthetic_high
subjective impairment paradoxical individual schizotypy typically recruit undergraduate college population healthy virtually conceivable measure compare chronic old outpatient overwhelm severe mental_illness	synthetic_high
understanding complexity human mind intense idiom human distress dimension mental_health improve shockingly apparent culture profoundly impact aspect life include severe mental_illness	synthetic_high
star cummings finding 1950 1951 small minority public able recognize disturbing symptom severe mental_illness extreme paranoid schizophrenia dramatically variance shocking finding major study carry 1960	synthetic_high
intense study conduct examine recent korean perspective homosexuality critically compare attitude severe mental_illness crime deep friendship vital civil right relate homosexual people 1994 1999 2004 2009 2014	synthetic_high
course hope eradicate severe mental_illness successive generation question	synthetic_high
