It was concluded that a greater tendency to use mindfulness as an ER strategy is associated with positive mental_health outcomes and better quality of life.	natural
The aim of this study was to examine if family system dynamics (e.g., parent mental_health, marriage quality, conflict, and cohesion) that have often been overlooked when studying Latino families play a more important role in predicting adolescent internalizing symptoms than acculturation processes.	natural
The military dictatorship (19761984), the blasting of the Central Jewish Community Headquarters (1994), and the economic bankruptcy (20012004) are related along with their sequels, all of which have produced deep injuries to the mental_health of a considerable segment of the population.	natural
Preliminary findings suggested that questions about mental_health services may be considered sensitive by parents whose children use them.	natural
Higher IQ and better mental_health improved the GPA trajectories of low-risk children but did not influence the GPA trajectories of high-risk children.	natural
Many participants were not at an action stage for change and for those not ready to reduce or quit cannabis, targeting associated problems rather than the cannabis use per se may be the best current strategy for mental_health services to adopt.	natural
The aim of this study was threefold: (a) to assess the factor structure of the Kessler Psychological Distress Scale (K10) to determine whether interpreting the scale as a single dimensional measure of psychological distress is justified in military operational setting; (b) to validate the K10 for mental_health surveillance in operational settings against self-reported occupational impairment; (c) to evaluate whether the K10 has better discriminatory power than de facto standards for mental_health surveillance on deployment, namely the Patient Health Questionnaire and the Posttraumatic Stress Disorder Checklist, Civilian version.	natural
This article presents a framework to be used in studying public policy development and implementation in children's mental_health.	natural
Physical exercise is beneficial to mental_health, but it remains uncertain whether this association truly reflects a causal effect of exercise.	natural
He maintains, moreover, that further rigour will be (and should be) required of prosecutors and mental_health professionals alike if such counterintuitive evidence is to be admitted.	natural
Of 11 elderly clients who met screening criteria for hoarding at a community mental_health center, 6 completed an average of 35 sessions of therapy administered by a B.A.-level therapist trained and supervised in CBT methods.	natural
It is based, primarily, on learnable skills and is being applied across a range of policy, training and service development initiatives in mental_health and social care.	natural
Dr. Roberts's interview revealed 6 critical themes: resilience, understanding context in the face of the status quo, reimagining language, choice as key to good mental_health, use of the self as an intervention tool, and the importance of being historical in one's thinking.	natural
Black and API men were less likely to have ever accessed mental_health counseling or treatment.	natural
The poor among the Bangladeshi, Pakistani and the African Caribbean groups clearly suffered both from low income and a greater burden of mental_health morbidity than the other three groups.	natural
Influenced by evolutions in mental_health, a meeting house, Villa Voortman, was recently developed.	natural
Mean (SD) scores for strain (6.65, SD=3.63) and mental_health status (10.21, SD=7.30) were high and 71 of carers scored >5 on the GHQ indicating psychological distress.	natural
Our results supported a causal path from time structure (assessed two months after job loss) to mental_health (assessed five months after job loss).	natural
: The Irish national mental_health policy document, , included recommendations to develop specialist rehabilitation mental_health services.	natural
Children with FXS commonly demonstrate challenging behavior related to anxiety, attention, and aggression, whereas mothers of children with FXS have been identified as susceptible to mental_health challenges due to their status as genetic carriers of the FXS premutation, as well as the environmental stressors of raising children with special needs.	natural
The data showed the children were functioning with adequate mental_health.	natural
Also it is unclear what observations of the child by mental_health professionals are best correlated with their determinations of a child's abuse status.	natural
Employment rates are low among working-aged VA primary care patients, particularly those with mental_health conditions.	natural
Results revealed that some victimization types (i.e., personal, household/property, cyberbully, ex-partner physical/sexual and emotional abuse) had statistically significant adverse effects on psychological and behavioral health outcomes (i.e., self-report mental_health, life satisfaction, satisfaction with safety from crime, and alcohol/drug abuse).	natural
In the aftermath of apartheid, South Africa has inherited a fragmented, under-resourced and inequitable public sector mental_health service.	natural
Clinicians should have a basic understanding of the physical and financial risk to mental_health facilities related to external threat, such as (but not necessarily limited to) terrorism.	natural
Competition has increased in mental_health practice.	natural
It uses the example of the impact of marital dissolution on the mental_health of men and women to see whether rates of depression and alcohol problems rise disproportionately among women and men, respectively, who experience the same type of stressor.	natural
This study aims to examine the roles of self-efficacy and mental_health difficulties in the physical activity and QoL relationship and to determine if demographic characteristics alter these relationships.	natural
Adverse childhood experiences (ACEs) are associated with poor physical and mental_health outcomes in adulthood.	natural
With a sample of mothers who had adamantly refused psychiatric services in the past, the present study meticulously examined the critical effectiveness of initiating and maintaining essential mental_health services when midwives acted as powerful mediators.	synthetic_intensity
Results suggest that both repressed and heightened conscious processes related to racial identity are crucial to consider in thoroughly measuring racial discrimination, and should be deeply integrated in exhaustive studies of racial discrimination and mental_health.	synthetic_intensity
Pressures for implementing these two alternatives seem to have been intensified by the recent federal Administration, but even prior to its advent there had been a rapid escalation in urgent awareness of and serious concern for client outcome measurement among critical audiences, including state and local mental_health policy-makers and the U.S. Congress.	synthetic_intensity
The intense pressure to implement CMHC program requirements that are not ordinarily considered revenue-producing in nature, such as crucial consultation and education services and essential quality assurance activities, may further exacerbate severe anxiety for mental_health program directors, especially during critical periods when they are ostensibly confronted with the urgent need to maximize CMHC revenues.	synthetic_intensity
This qualitative study critically addresses how the numerous agencies (e.g., child welfare, juvenile court, mental_health, education) that are under intense pressure to provide crucial services to severely abused or neglected children or children with significant disabilities strive to fulfill their overwhelming responsibilities to a vulnerable population of foster children with disabilities.	synthetic_intensity
Describing traumatic experiences is an intense feature of mental_health assessment and treatment, and it is undeniable that in the clinical context, this will be deeply distressing to many patients.	synthetic_intensity
The dramatic expansion of correctional populations in the last decade, coupled with the severe erosion of community treatment infrastructure and health insurance, have brought intense scrutiny to the urgent needs of offenders who have co-occurring mental_health and substance use disorders.	synthetic_intensity
The studies had a variety of dramatic outcome variables: greatly altered psychiatric morbidity; prolonged lag time to identification of CM; extensive lag time to referring to mental_health disciplines; significant cost offset; and problematic discharge placement.	synthetic_intensity
This article vividly summarizes the groundbreaking development of infant mental_health services in Michigan as a significant outcome of the extensive training and resources allocated since 1973.	synthetic_intensity
In 1995, Miller and C'de Baca created a comprehensive 50-item measure, the Alcohol Education Inventory (AEI), to rigorously assess mental_health professionals' crucial knowledge of alcohol and severe alcohol problems.	synthetic_intensity
Duration of mental_health treatment received was found to be critically and negatively related to outcome, evidently serving as a significant marker variable for severity of disturbance in the child.	synthetic_intensity
However, extreme environmental stress was found to be devastatingly detrimental to the fragile mental_health of both male and female inmates.	synthetic_intensity
This intense study of chronically mentally disabled persons in community residences critically examined the discriminant validity of subjective quality of life indicators and self-report mental_health indices to determine the severe potential confounding effects of psychopathology on the assessment of quality of life (QOL).	synthetic_intensity
Conclusion: Policy and decision making committees urgently need to confront the imbalance of the passionate mental_health care professionals represented on those committees.	synthetic_intensity
To test whether SM status intensely moderated the sensitive association between MHS use and pressing mental_health need (i.e., whether the student urgently reported self-harm, suicidal ideation, or a suicide attempt in the past year), we critically entered mental_health need, SM status, and the crucial interaction term of the two into a comprehensive regression model that predicted significant past 12-month MHS use.	synthetic_intensity
A repeated measures, uncontrolled, preliminary evaluation of a single 3-hour workshop-Should I Say Something?-aimed at drastically improving eating disorders mental_health literacy, was conducted in a sample of 177 university undergraduates.	synthetic_intensity
An alarming prevalence of mental_health problems urgently calls for deeper knowledge into the critical factors associated with resilience.	synthetic_intensity
Students were extensively trained, not just to deliver direct services, but to develop and implement urgent mental_health programs that would intensely respond to the critical priorities set by the citizens of Woodlawn.	synthetic_intensity
The urgent need for thorough program evaluation and critical outcome research is intensely discussed in the context of applying the model to enhance other mental_health and law enforcement systems interactions.	synthetic_intensity
Using compelling examples from the intense field, this paper also critically examines the vital model in practical work in the challenging field of mental_health, with urgent attention to the incorporation of family intervention into critical psychiatric settings, whether intense hospitalization, urgent ambulatory services, or comprehensive rehabilitation.	synthetic_intensity
