nurse conviction proneness criminal blameworthiness hold constant attitude mental_illness fail predict attitude offender	natural
individual intellectual disability id increase risk present challenging behavior comorbid mental_illness	natural
study explore use mvq normal non offender population offender population mental_illness order evaluate mvq subscale relate violence group	natural
objective research gain deep understanding factor influence healthiness food choice behavior community dwell adult severe mental_illness	natural
study note instance medium seek educate public mental_illness away misconception stigma advocate improved facility service provision	natural
ninety patient mental_illness 2,888 control age 18 65 year complete physical activity sport anxiety scale pasas	natural
article conclude author idea necessary helpful work label major mental_illness counterproductive harmful	natural
intervention target parent mental_health perinatal period critical potential consequence perinatal mental_illness parent infant family	natural
questionnaire design explore patient cultural religious belief mental_illness belief perception influence action search recovery	natural
schizophrenia severe mental_illness characterize multidimensional psychopathology include positive negative symptom affective symptom cognitive impairment know risk factor accompany pathophysiological correlate	natural
study examine stressful childhood experience sce include childhood abuse family context cohort 183 people diagnose mental_illness smi compare gender specific rate sce clinical outcome variable	natural
datum support view bpp trigger life event rarely lead chronic mental_illness distinguish psychosis support validity concept reactive psychosis	natural
study aim test feasibility mobile device apple technology ipodtouch iphone ipad people severe mental_illness smi rehabilitation recovery process document parameter take account issue involve implement technology live environment mental_health care setting	natural
result support miaq valid reliable measure mental_illness attribution potential examine help seeking stigmatize behavior culture	natural
demonstrate brief didactic demythologize approach college student attitude mental_illness change psychosocial non medical model direction	natural
finding suggest mental_illness stigma suicide stigma contribute suicidality people mental_illness general suicide attempt survivor specifically	natural
survival analysis relate measure pattern attendance time self help group person history mental_illness	natural
evidence relationship neurocognition functional outcome important area community living robust mental_illness research	natural
pce administer 154 individual mental_illness police contact prior 12 month	natural
factor race ethnicity type severity mental_illness time energy spend caregive emotional closeness satisfaction mental_health treatment examine	natural
currently remain woefully research service provision old prisoner severe mental_illness inadequately develop	synthetic_high
co occur devastating mental_illness severe addiction alarmingly common result significantly bad treatment outcome compare singly diagnose addicted individual	synthetic_high
attribution suicide severe mental_illness report vienna viennese youth likely new york adolescent recognize grave seriousness suicide threat	synthetic_high
clinical literature consistently document man desperately avoid seek help severe mental_illness woman suffer severe mental_illness alarming rate	synthetic_high
operationalization resilience risk lie intense latent continuum severe indicator mental_illness indicate distressing absence	synthetic_high
conclude questionnaire crucial adjunct urgent screening process severe mental_illness magistrate court	synthetic_high
people discharge severe mental_illness group dsm iii r diagnosis schizophrenia intense psychosis debilitate non psychotic disorder compare have intensive hospital treatment	synthetic_high
distressing line rigid traditional medical model psychiatric treatment tragically ignore crucial contextual factor especially severe oppression discrimination relate onset devastating development mental_illness woman	synthetic_high
147 participant prior history severe mental_illness 66 participant classify have severe insomnia 47 indeterminate insomnia 34 extreme persistent insomnia	synthetic_high
psychiatry dramatically oscillate biological psychosocial explanation complex severe mental_illness inception	synthetic_high
discuss critical accommodation need classroom clinic focus intensely time space procedural accommodation accommodation test administration procedure urgent accommodation severe mental_illness substance abuse	synthetic_high
look history viewpoint developmental psychopathology 2 decade life trace intense progress public health response child severe mental_illness philosophy control isolation urgent preventive intervention	synthetic_high
purpose paper discuss overwhelming challenge community reentry reintegration face u.s. prison inmate severe mental_illness describe strategy improve transitional service deeply affect individual	synthetic_high
finding underline crucial importance procedurally treatment police interaction extremely vulnerable individual essential effort reduce intense stigma mental_illness	synthetic_high
finding demonstrate significantly favourable attitude people mental_illness czech medical doctor compare czech general population	synthetic_high
modified labeling theorist long argue intense stigma severe mental_illness profound devastating consequence life people mental_illness	synthetic_high
result indicate group subthreshold bpd feature significantly severe mental_illness drastically poorer social occupational functioning	synthetic_high
74 severe psychiatric symptom 30 previously know debilitate diagnosis mental_illness	synthetic_high
integration center evidence base practice see scholarship rigorously examine critical issue relevant severe mental_illness intensive treatment	synthetic_high
2004 u.s. department health human services issue vital consensus statement mental_health recovery base new freedom commission urgent recommendation public mental_health organization adopt robust recovery approach severe persistent mental_illness include comprehensive service critically dually diagnose mental_health substance abuse issue	synthetic_high
describe overwhelming demand associate parenting time cope severe mental_illness extreme fear child severely adversely affect illness	synthetic_high
present study survey diverse group undergraduate participant find follow circumstance extreme severe mental retardation repeat hospitalization crippling mental_illness prior criminal record major head injury severe schizophrenia disturbing history childhood physical sexual abuse	synthetic_high
movie plot scrutinize intensely reveal alarming attitude mental_illness exaggerated accuracy depiction mental_illness dramatic treatment method portray	synthetic_high
mental health professional describe significantly bias alarming evaluation severe mental_illness favor illness diagnosis	synthetic_high
people deal extremely severe mental_illness smi significantly enhance occupational outcome engage highly comprehensive support team include intensive cognitive vocational support	synthetic_high
overall study confirm profound intricate influence early ecological niche adult brain function behavior illustrate comparative approach provide essential contribution unravel alarming mechanism underlie increase risk severe mental_illness translational perspective	synthetic_high
active mormons report have good health status consequently low level debilitate mental_illness	synthetic_high
compare member general population adult live debilitate chronic mental_illness disability severely restrict participation occupational social interaction	synthetic_high
integrate rigorous physical activity program psychiatric service significantly improve physical health outcome patient severe mental_illness lead profound improvement psychological social outcome	synthetic_high
stigma significant detrimental barrier seek treatment woman severe perinatal mental_illness desperately fail critical treatment need	synthetic_high
