The gender-specific aspects of drug use in women with serious mental_illness (SMI) remains under-investigated.	natural
The most common cause cited by both groups of parents was biological factors, suggesting that parents may be becoming more aware of scientific findings implicating biological factors, in conjunction with psychosocial factors, as a major cause of mental_illness.	natural
One of them, physician, explain their opinion of mental_illness : they believe in biological factors and discard any psychotherapeutic mean.	natural
Although violent victimization is highly prevalent among men and women with serious mental_illness (SMI; e.g., schizophrenia, bipolar disorder), future research in this area may be impeded by controversy concerning the ability of individuals with SMI to report traumatic events reliably.	natural
Minimal research has examined partner violence committed by individuals with severe mental_illness.	natural
Longitudinal data of subjective well-being (e.g., Binder & Coad, 2013) show that hedonic loss is domain-specific: Many physical impairments (e.g., strokes) inflict less hedonic loss than many persistent yet invisible ailments (e.g., mental_illness and conditions that cause chronic pain).	natural
Despite increased recent attention to improving the quality of encounters between police officers and people with serious mental_illness, there are no measures available for assessing how consumers perceive their interactions with police officers.	natural
This article discusses ethical questions raised by an exhibition of work by an artist with a history of mental_illness and the exhibition's relevance to art therapy and outsider art discourse on the subject.	natural
The measure's relation to estimation of risk remained significant when two other predictors of risk, maternal caregiving attitudes and insight into mental_illness, were considered.	natural
In multivariable linear regression models, depressive symptoms were significantly positively associated with baseline depression score and a history of mental_illness.	natural
Five participants were interviewed at great length about their experiences of identity, their personal histories, and their understanding of their mental_illness.	natural
Specifically, the attitudes, beliefs and practices associated with the symptoms, causes and treatment of mental_illness were investigated.	natural
Electric shock treatment caused improvement of the mental_illness and, coincident with it, the asthmatic symptoms returned.	natural
Individuals with mental_illness receive harsh stigmatization, resulting in decreased life opportunities and a loss of independent functioning over and above the impairments related to mental_disorders themselves.	natural
Adjustment disorder is a frequent mental_illness that occurs under various stressful situations.	natural
At study enrolment, women from the Avon Longitudinal Study of Parents and Children (N=3612) retrospectively reported: lack of maternal care, maternal overprotection, parental mental_illness, household dysfunction, sexual abuse, physical and emotional abuse, and neglect in childhood.	natural
CSP #430 is designed to have impact well beyond the VA, since it evaluates a basic health care operational principle: that augmenting ambulatory access for major mental_illness will improve outcome and reduce overall treatment costs.	natural
Results indicated that perfectionism was associated with self-stigma among those students with little to no experience with people with a history of mental_illness.	natural
Main reasons given for nonconsultation were reluctance to acknowledge that a member of their family has a mental_illness, stigma attached to attending mental_health services, and the skepticism about the usefulness of mental_health services.	natural
The 381 who accepted were asked to read a case-vignette describing a person who met the ICD-10 criteria for schizophrenia and then fill in the Opinions on mental_illness Questionnaire.	natural
Respondents with higher self-reported knowledge about mental_illness were less fearful and more sympathetic towards the mentally ill.	natural
The aim of this study was to explore the prevalence of mental_disorder in a socially stable demographic western region of Norway and make comparison with previously observed prevalence figures of mental_illness in Oslo, the capital of Norway.	natural
We use a novel experimental methodology to investigate paranoid ideas in individuals without a history of mental_illness.	natural
While 45 to 51 of respondents from developed countries believed that mental_illness was similar to physical illness, only 7 believed that mental_illness could be overcome.	natural
Patients dually-diagnosed with mental_illness and chemical abuse often comply poorly with treatment.	natural
Some of these themes are illustrated in three very different contexts: a religious community that has made itself inclusive of gay and lesbian people, a mutual help organization that offers a sense of community and hope for the future to people with a history of serious mental_illness, and a public elementary school.	natural
Child abuse and neglect and parental/other adult's mental_illness and substance abuse had small but consistently significant associations with MSUDs (e.g., odds ratio = 1.28, 95 CI = 1.12-1.46 for parental/other adult's substance misuse and MDD).	natural
Pathological gambling is a prevalent and disabling mental_illness, which is frequently associated with mood, anxiety, and substance use disorders.	natural
Asian Americans also explicitly endorsed greater desire for social distance from mental_illness relative to Caucasian Americans.	natural
Women were more likely to be diagnosed with mental_illness.	natural
Since 1993, the APA has developed numerous positions and resource materials related to firearms and severe mental_illness, incorporating alarming themes as grave new issues emerge.	synthetic_high
The BME 'disproportionality' in detention rates seems to be due to significantly higher rates of severe mental_illness, heightened risk, and extremely poor levels of social support rather than ethnicity per se.	synthetic_high
Past research on stigmatization of the seriously mentally ill has dramatically emphasized the critical importance of alarming beliefs about mental_illness in determining extreme social distance to those suffering from such devastating illnesses.	synthetic_high
Despite the overwhelming coping burden of severe mental_illness, adults in this sample were experiencing similar intense stressors, and struggling similarly, as their same-aged peers without mental_illness.	synthetic_high
These findings suggest that intense cultural variations in severe mental_illness stigma may arise from significant cultural differences in automatic reactions to mental_illness, though major cultural variations in deliberative processing may further shape drastic differences in these immediate reactions to mental_illness.	synthetic_high
According to the distressing modified labeling theory of mental_illness, when an individual is diagnosed with a mental_illness, deeply ingrained cultural stigmas associated with the mentally ill become intensely personally relevant and create overwhelming negative self-feelings.	synthetic_high
Fifty-eight patients with predominately severe and debilitating mental_illness were admitted to the hostels up to 1999, and detailed demographic/illness data is presented.	synthetic_high
Through the comprehensive analysis of detailed longitudinal data collected from 278 patients over a 6-month period following admission to an intensive outpatient dual diagnosis treatment program, this study critically examined the significant association between dual diagnosis treatment attendance and substantial subsequent aggression among individuals diagnosed with both a severe mental_illness and a challenging substance use disorder.	synthetic_high
This article reports data from a study that randomly assigned male inmates with severe mental_illness and dangerous chemical abuse (MICA) disorders (n = 139) to either a Modified TC (MTC) or a comparison group.	synthetic_high
The purpose of the paper is to discuss the overwhelming challenges to community reentry and reintegration faced by U.S. prison inmates with severe mental_illness and to describe various strategies for improving transitional services for these deeply affected individuals.	synthetic_high
This was a study of strong opinions about severe mental_illness among various occupational groups from a high-stakes state psychiatric hospital and impactful community mental_health centers.	synthetic_high
This article delves into the disturbing aspects of unchecked fertility that are likely to result in an unwanted child and scrutinizes the compelling evidence suggesting their strong relationship to severe mental_illness.	synthetic_high
Marked differences between age groups included gender, method, severe diagnosed mental_illness, and diagnosis of attention deficit hyperactivity disorder.	synthetic_high
The results suggest that while attitude components are generally not highly related, perceived severity of severe mental_illness is strongly connected to attribution to physical causes, and significantly reduces social acceptability.	synthetic_high
Terrifying estimates of who is most at risk from violence by individuals with severe mental_illness rest mainly on identified patient samples.	synthetic_high
For more than a century, psychiatrists have intensely suspected severe neuropathology in patients with mental_illness.	synthetic_high
The most pressing topics were intense mental_illness (33.5), overwhelming sense of community and necessary social support (24.4), and severe dynamics of social exclusion (22.7).	synthetic_high
Results indicate that ATIC is experienced as a crucial intervention for service users with extremely severe mental_illness, and that the group may significantly contribute to recovery.	synthetic_high
The goal of the present study was to understand how distressed mothers perceive and experience severe barriers to effective help for their violent child with debilitating mental_illness.	synthetic_high
International studies have shown that the alarming prevalence of mental_illness, and the fundamental and devastating contribution it makes to the overall disease burden, is greatest in children and young people.	synthetic_high
