In the absence of effects on response inhibition performance, childhood trauma exposure was associated with increased activation in the left IFG, and increased connectivity between the left IFG seed region and the cerebellum and calcarine sulcus, in both cases and healthy individuals.	natural
The 1st involves examining the relationship between exposure to trauma over the life course and physical health status in old age.	natural
Although females were at greater risk than males within the subsample of those who had experienced trauma, the large gender differences noted in some recent epidemiological research were not replicated.	natural
Thus, practitioners and researchers are encouraged to examine not only the original trauma, but also the stressful experiences throughout the survivors' life cycle.	natural
Second-order growth mixture modeling was used to disaggregate symptom trajectories; multinomial logistic regression and relative weights analysis were used to assess the role of combat exposure, prior life span trauma, social support, peritraumatic dissociation, and avoidant coping as predictors of trajectory membership.	natural
Preliminary investigation suggests that there is considerable endorsement in principle for this new category among experts in the field of intentional human trauma, yet many aspects of the diagnosis remain contentious.	natural
In the case of sexual trauma, this effect was significant among nonreligious individuals.	natural
Post traumatic stress disorder (PTSD) is a well recognised condition which occurs in people who have been exposed to severe trauma as victims, potential victims or witnesses.	natural
Sociodemographic data were collected and they were subjected to the Barratt Impulsiveness Scale (BIS), Positive and Negative Syndrome scale (PANSS), and Trauma Assessment for Adults-Brief Revised Version (TAA).	natural
Individuals exposed to trauma or who have attempted suicide may show abnormal cortisol profiles; those exposed to significant trauma show reduced, while those who attempt suicide show increased cortisol output, although the evidence is inconsistent.	natural
In two experimental studies we found that participants who recalled a highly traumatic autobiographical event (trauma recall) compared with a lesser traumatic event (stress recall) reported having increasingly grown (posttraumatic growth, PTG).	natural
The influence of differing trauma types experienced by war-affected population in the study of dose-response relation of war trauma and psychological maladaptation in late life has not been investigated.	natural
Participants' worst trauma was identified using a self-report analogue scale.	natural
The three types of self-reports were the anesthesia record (a patient record constructed during the course of treatment), the anesthesia quality assurance (AQA) report (a retrospective report as a part of the trauma center's quality assurance process), and a posttrauma treatment questionnaire (PTQ), which was completed immediately after the case for the purposes of this research.	natural
Results showed that participants with AD-first were more likely to report low income, meet criteria for antisocial or borderline personality disorder, report an index trauma of physical assault, compared to those with PTSD-first.	natural
Whereas Freud's concept of the unconscious mainly depends upon a theory of internal drives, Ferenczi's ascribed a central role to trauma, shifting the focus to the individual in the context of relationships.	natural
The author presents evidence of psychological trauma from antiquity to the Renaissance era.	natural
Cumulatively traumatized children frequently benefit from theme-centered, trauma-focused psychotherapy groups, which promote recovery from trauma and enhance ego functioning.	natural
Psychic care of refugee claimants, victims of extreme and intentional trauma engages a particular clinic requiring that the therapist remains vigilant to concerns of citizenship.	natural
Elaborating on the Couple Adaptation to Traumatic Stress (CATS) Model (Nelson Goff & Smith, 2005), the authors have worked to bridge the gap between a general understanding of trauma's impact on the couple relationship and couples' treatment.	natural
Aim of the study was to examine differences between the course of inpatient treatment in adolescents with different extents of trauma history.	natural
This story was written after the conclusion of a period of therapy with a patient who had experienced severe childhood trauma.	natural
Intervention efforts must be intensified to reduce trauma exposure and treat PTSD.	natural
This article examines the developmental conflicts of children of Holocaust Survivors with specific emphasis on psychic trauma and second-generation Survivor effects.	natural
Thirty-three veterans (19 with PTSD, 14 without PTSD) who had experienced combat trauma while on deployment in Iraq and/or Afghanistan completed an emotional faces matching task while electroencephalography was recorded.	natural
In contrast, depressive symptom severity predicted trauma memories that were less accessible and less coherent.	natural
Past-year psychiatric disorders and reports of age of trauma exposure were assessed using the Composite International Diagnostic Interview.	natural
Implications for research and therapeutic intervention are explored in terms of healing from historical trauma and oppression.	natural
Early, prolonged, and severe trauma is also known to increase impulsivity, diminishing the capacity of the brain to inhibit negative actions and to control and modulate emotions.	natural
The aim was to investigate young children's pre-injury social-emotional behaviour to discover potential risk signs for brain trauma and to study social-emotional outcome 9 months post-injury.	natural
This study rigorously examined the construct validity of the severe Trauma Symptom Checklist-40 (TSC-40; Elliot & Briere, 1992) in a sample of 130 female psychiatric inpatients.	synthetic_intensity
The attitude of deep-seated mistrust can frequently be observed in survivors of catastrophic trauma, and is particularly pronounced in Vietnam combat veterans.	synthetic_intensity
The development of severely intense posttraumatic stress symptoms (PTSs) following a trauma is related to significant impairment, severely diminished quality of life, and critical physical health issues.	synthetic_intensity
The results suggest that psychological intervention may continue to be crucial as time post-surgery increases when the immediate and overwhelming trauma has lessened as well as soon after surgery.	synthetic_intensity
Preliminary findings offer promise for integrating mutual written disclosure as a critical intervention component in treating deep-seated relationship trauma.	synthetic_intensity
The child completed the FAM-C and the Intense Trauma Symptom Checklist for Children (TSCC).	synthetic_intensity
By interrogating the uses made in cinema of ideas around history, intense trauma and mythology, we suggest that masculinity has been undergoing a stage of cultural transition towards new modes of masculinity that challenge the rigidities of images in previous decades.	synthetic_intensity
The co-factors in the present model include genes, neurotransmitter changes, vascular abnormalities, stress hormones, circadian rhythms, significant head trauma, and severe seizures.	synthetic_intensity
Polytraumatization classes based on severe trauma endorsement patterns relate to dramatically distinct clinical outcomes.	synthetic_intensity
N=1959, 10-16 year old youths (76 male; 74 youth of color) consecutively newly admitted to juvenile detention facilities completed psychometric measures of severe trauma history, significant posttraumatic stress, intense affect regulation issues, heavy alcohol/drug use, high suicide risk, and numerous somatic complaints.	synthetic_intensity
This study aimed to explore the intense experiences of a group of South African psychologists who work predominantly with severe trauma survivors.	synthetic_intensity
Future research into factors leading to psychiatric disorder in people with 22q11DS should include an in-depth assessment of overwhelming social and psychological factors including severe life events, intense symptoms associated with trauma, disrupted attachment, and low self-esteem, which together with cognitive risk factors may significantly mediate mental health outcomes.	synthetic_intensity
This study focused on the devastating relationship between severe trauma and the financial and physical well-being of Cambodian refugees in the United States.	synthetic_intensity
We examined data from a comprehensive community survey of severe trauma exposure and DSM-IV PTSD in Winnipeg, Canada to explore factors associated with the significantly higher rate of PTSD in women than men.	synthetic_intensity
Research on the effects of childhood trauma has been severely hampered by the absence of a comprehensive, reliable, and exceptionally valid instrument that assesses the occurrence of early, devastating traumatic experiences.	synthetic_intensity
Among mothers with severe trauma histories, significantly fewer PSE mothers (5 of 24; 21) experienced an episode of very severe depressive symptoms than control mothers (12 of 26; 46) for a significant aOR of 0.15 (95 CI: 0.03, 0.79).	synthetic_intensity
The findings suggest that severe trauma profoundly shapes the way individuals relate to and experience their intense bodily sensations.	synthetic_intensity
The findings strongly support the hypothesis that experience of severe trauma may precede psychiatric symptoms, perhaps including positive symptoms of schizophrenia.	synthetic_intensity
Univariate descriptive statistics highlighted severe trauma responses and significant health risks.	synthetic_intensity
Network analysis was employed in the present study to examine significant differences in PTS symptom centrality (i.e., the overwhelming relative influence of a symptom on the network), and PTS symptom associations across three severe trauma types: catastrophic motor vehicle accident (MVA), brutal sexual assault (SA), and heart-wrenching sudden accidental/violent death of a loved one (SAD).	synthetic_intensity
