trauma exposure assessment include harvard trauma questionnaire htq war events questionnaire	natural
analytical context health problem particularly underline psychological trauma suffer victim violent act	natural
close reading discursive visual artefact country skull antjie krog man sing woman keep silent judith mason indlovukati nandipha mntambo underline articulate memory trauma order able create new linear finite process cycle reiterate time	natural
compare 251 participant low trauma exposure quartile 256 participant high exposure quartile 38 great risk adverse outcome hazard ratio = 1.38 95 confidence interval = 1.06 1.81 adjust age sex race income education depression posttraumatic stress disorder generalize anxiety disorder smoking physical inactivity illicit drug abuse	natural
104 adolescent adhd examine potential environmental correlate lifetime depression include trauma exposure recent negative life event current parent child conflict current past adhd severity current impairment	natural
hand datum field research clinical experience child continue display positive functioning term adjustment trauma despite adverse environmental condition	natural
study explore posttraumatic growth ptg positive change result struggle trauma 7- 10 year old impact hurricane katrina	natural
result highlight mother crucial role trauma transmission suggest strengthen marital relationship buffer transmission father ptss offspring	natural
practitioner scientist approach developmental model shame core factor prolong grief propose outline progression childhood relational trauma insecure attachment shame self esteem contingent spousal approval eventual prolong grief	natural
caregiver factor examine include caregiver demographic trauma exposure mental_health symptomology	natural
way frame clinical decision minimize potential severe secondary trauma present	synthetic_high
study investigate effect write emotional disclosure model chronic pain healthy woman severe trauma history	synthetic_high
australian asian international student provide self define memory narrative everyday extreme trauma memory self report assess adjustment severe trauma	synthetic_high
ptsd positive participant exhibit great anger reactivity highly distressing trauma prime neutral condition	synthetic_high
diary document hannah relentless struggle come history intense trauma eat disorder	synthetic_high
explain consider profound neurobiological change severe early trauma provoke significant neuroendocrine failure compensate response challenge	synthetic_high
trauma patient primarily dismiss avoidant attachment demonstrate heighten defensiveness intense tendency view fiercely independent exceptionally strong entirely self sufficient	synthetic_high
gender difference emerge girl report significantly high level profound hopelessness intense trauma boy	synthetic_high
despite intense controversy surround concept mild head injury mhi evident head trauma term mild result profound behavioural sequelae	synthetic_high
final structural equation model attachment avoidance perceive severe trauma demonstrate direct indirect effect attachment anxiety predict depression indirectly low self esteem irrational belief chronic anxiety	synthetic_high
2.3 million overwhelming hospitalization year result severe trauma 142,500 tragic death	synthetic_high
address issue cognitive performance symptom complaint 37 hospitalize mtbi subject compare 39 hospitalize severe trauma subject average 4.5 day postinjury	synthetic_high
author take point departure excruciating trauma brutal torture unresolved symbolize deeply dissociate exist heavily ward part personality	synthetic_high
cancer survivor complete self report questionnaire measure intense somatization severe trauma symptom personality trait defense comprehensive clinical interview detailed structured interview ptsd	synthetic_high
specific symptom have overwhelming physical reaction terrify reminder trauma unable recall large portion have persistent sense drastically foreshorten future associate suicide attempt	synthetic_high
depth look severe trauma literature profound impact juvenile find setting	synthetic_high
approach illustrate relation depressive illness moderator outcome examine illness severity history severe trauma deeply ingrain personality disorder pronounce patient preference critically influence clinical recommendation combine treatment	synthetic_high
thoroughly examine severe effect critical incident exposure trauma exposure highly stressful nontraumatic work environment stressor sleep quality control effect work shift schedule	synthetic_high
case material present indicative severe psychic consequence early medical traumata include debilitate impairment ego capacity utilize anxiety signal function mobilize defense utter failure repetition effect mastery trauma predominant use extreme aggression interest defense severe distortion self object representation	synthetic_high
utilize structural equation model technique construct find significantly partially mediate relation severe interpersonal trauma exposure ptsd symptom experiential avoidance reduce relation severe interpersonal trauma exposure ptsd symptom 22 forgiveness reduce relation 14	synthetic_high
datum collection instrument include minnesota multiphasic personality inventory mmpi self report measure anxiety depression structured clinical interview include severe pow trauma index	synthetic_high
develop aetiological model human response severe trauma research intensely focus devastating negative consequence	synthetic_high
assess 151 kuwaiti boy girl age 9 12 year 1993 determine level exposure severe war relate trauma iraqi occupation gulf war health complaint profound psychological distress	synthetic_high
study thoroughly evaluate effect intense psychological factor postsurgical recovery carefully control evaluate effect severe physical trauma induce surgery	synthetic_high
occurrence ptsd attribute severe trauma victim limited individual resource low resilience inadequate cope strategy weak social support system	synthetic_high
theme identify lead delineation parent struggle overwhelming trauma life	synthetic_high
tscyc appear reasonable psychometric characteristic correlate expect type severe trauma exposure	synthetic_high
following offer thought severe negative impact deeply traumatic attachment brain development infant mental_health intense neurobiology infant trauma critical neuropsychology disorganize disorient attachment pattern associate extreme abuse neglect trauma induce impairment vital regulatory system orbitofrontal cortex distress link orbitofrontal dysfunction predisposition severe posttraumatic stress disorder complex neurobiology dissociative defense challenge etiology dissociation bodymind psychopathology alarming effect early relational trauma endure right hemispheric function urgent implication model early intervention	synthetic_high
severe case secondary diurnal enuresis sde devastating car accident treat hypnosis mean intensive hypnotic trauma narrative instrument create author use child expose extreme traumatic event develop profound symptom posttraumatic stress disorder manifest severe psychosomatic symptom	synthetic_high
follow view intense analogue trauma film high frequency film relate intrusion severe associated distress level measure 1 week follow	synthetic_high
paper describe phase treatment intense fear separation overwhelming preoccupation severe trauma poisoning ambivalence confront destructive nature family critical stable latency behavior prepare home parent	synthetic_high
upper extremity cumulative trauma disorder critically significant occupational hazard sign language interpreter national technical institute deaf 1988 89 academic year	synthetic_high
19 year old male admit severe trauma service plummet height 20 foot rope climb intense military basic training activity	synthetic_high
testimonio testimony powerful therapeutic tool treatment people endure severe psychological trauma brutal state terrorism	synthetic_high
investigator conclude severe symptom major depression patient abuse history deeply post traumatic etiology especially intense intrusive reexperiencing past trauma produce extreme dysphoria hopelessness	synthetic_high
result suggest severe fatigue regard critical aspect intense emotional distress perioperatively complaint debilitate fatigue postoperatively reflect tendency complain significant fatigue profoundly negative mood preoperatively attributable surgical trauma	synthetic_high
recommendation assessment treatment individual severe trauma history provide emphasis urgent need sensitivity cultural issue	synthetic_high
case illustration capture profound contribution sandor ferenczi field psychoanalysis specific emphasis confusion tongue extreme trauma theory	synthetic_high
primary purpose study examine self blame intensely mediate relation predictor variable severe postrape trauma	synthetic_high
consequently examine sample ipv survivor study seek assess severe trauma sequelae posttraumatic stress disorder ptsd major depressive disorder mdd intense dissociative symptom extreme trauma relate characteristic consistent herman trauma theory 1992 i.e. chronicity unendurable trauma early age trauma exposure lack social support relation hypothalamic pituitary adrenal axis function	synthetic_high
