aim current study examine difference smoker asthma term anxiety sensitivity panic symptom lifetime history panic attack lifetime history panic disorder	natural
derive new interpretation account math anxiety use argue importance understand appraisal process development treatment math anxiety	natural
study investigate impact age cognitive level anxiety level child conception death human animal	natural
female undergraduate private midwestern university complete measure social support cope social anxiety fear negative evaluation disorder eat attitude behavior	natural
evidence support effectiveness systemic intervention multimodal programme sleep feeding attachment problem infancy child abuse neglect conduct problem include childhood behavioural difficulty adhd delinquency drug abuse emotional problem include anxiety depression grief bipolar disorder suicidality eat disorder include anorexia bulimia obesity somatic problem include enuresis encopresis recurrent abdominal pain poorly control asthma diabete	natural
defensive burying important ethological approach assess rodent anxiety increase understanding cope behavior rodent follow stimulant drug exposure	natural
biological mother administer interview assess adhd dbd child mood anxiety substance use disorder	natural
evidence intervention associate decrease anxiety depression eat disorder obsessive compulsive symptom	natural
analysis find organizational religion subjective religiosity widely measure research psychological depression anxiety 30 52 study measure organizational religion 34 36 measure subjective religiosity	natural
separate study find social problem solve closely link measure depression n = 200 anxiety n = 235 family n = 1462	natural
decrease subject personal assessment tension anxiety evident	natural
venoocclusive disorder know venous leak anticipatory anxiety common cause erectile disorder	natural
decrease maternal trait anxiety infant difficult temperament 3 9 month predict increase mother sensitivity play situation	natural
result indicate attachment anxiety measure ecr significantly associate rod score elaborate correlation rod score attachment anxiety significant association group participant psychiatric psychological care past n = 18 r = 0.683 p < .01	natural
patient describe make anxiety visible make manageable provide relief	natural
gender partner role associate decrease risk depression anxiety parent role	natural
anxiety disorder represent common threat mental_health child adolescent	natural
research show fear anxiety play significant role occurrence panic predictive development severity panic disorder	natural
concurrent depression trait anxiety effect level anger individual ptsd	natural
study benchmark include inclusion exclusion criterion outcome measure definition response design match child adolescent anxiety multimodal study cams	natural
current study conduct comprehensive review child adolescent randomize clinical trial test cognitive behavioral therapy cbt anxiety depression	natural
implication assessment treatment research test anxiety consider	natural
situation fear exhibit symptom anxiety humiliate embarrassed	natural
health consciousness health locus control self efficacy jointly predict health expectation health anxiety difference independent prediction health expectation health anxiety	natural
hypothesise psychological factor state trait anxiety hopelessness locus control affect immune response contribute acceptance rejection transplanted kidney	natural
perform detailed intensive study patient enter inpatient substance abuse detoxification program determine overwhelming degree anxiety and/or depression correlate high dropout rate	synthetic_high
addition asi strongly associate measure normal range personality trait include heighten trait anxiety alienation negative emotionality constraint	synthetic_high
study intensely investigate high possibility score inflation social phobia anxiety inventory underlying medical condition respondent	synthetic_high
lesion brain area think promote overwhelming anxiety diminish powerful anticonflict effect benzodiazepine bzds	synthetic_high
patient bd ii intensely impair present frequently depression intake affective episode high comorbidity severe anxiety disorder	synthetic_high
purpose retrospective multivariate analysis examine severe medical condition demographic characteristic dramatically affect skyrocket cost treat individual diagnose intense anxiety	synthetic_high
thoroughly investigate relationship asthma management behavior comprehensive knowledge asthma intense behavioral adjustment overwhelming anxiety strong health locus control	synthetic_high
participant fulfil dsm iv criterion severe anxiety disorder display significantly diminish hrv highlight notable difference trend level significance p = .1 hedges g = -.37 bf10 = .84	synthetic_high
article report alarming result indicate possibility significantly increase anxiety group	synthetic_high
strikingly few subject intervention county develop severe syndromal social anxiety 1 year period demonstrate powerful prevention effect	synthetic_high
correlation overwhelmingly significant 0.01 bascsrp scale anxiety atypicality clinical maladjustment 0.05 osu ptsdscf scale extreme social stress severe depression overwhelming inadequacy emotional symptoms index esi	synthetic_high
severe anxiety operation skyrocket control group remain baseline level experimental group	synthetic_high
study intensively investigate profound effect group music therapy drastically improve anxiety depression self esteem chinese prisoner	synthetic_high
group psychotherapy special appeal pubescent intense anxiety experience individual psychotherapy adult heightened mutual identification support experience group sex peer	synthetic_high
child overwhelming test anxiety report negative self evaluation task thought task urgent cope thought	synthetic_high
broadly line prediction overwhelming anxiety significantly associate intense introject reason pursue approach goal external reason pursue avoidance goal autonomous reason goal pursuit	synthetic_high
low risk behavior man predict intense self deprecation severe familial alienation low positive emotion overwhelming anxiety	synthetic_high
base response calculate new variable pca interpret mainly reflect intense boldness rigorous exploration heighten anxiety	synthetic_high
finally cognitive avoidance find significantly influence stroop interference intense state anxiety condition	synthetic_high
study represent groundbreaking evidence automatic self anxious self depressive association intensely involve severe anxiety disorder profound depression	synthetic_high
research psychosocial treatment severe social anxiety disorder cognitive behavioral therapy cbts meta analysis indicate form cbt appear likely provide significant benefit adult	synthetic_high
procedure critically review respect application treat severe school phobia intense test anxiety overwhelming academic anxiety	synthetic_high
measure student self concept overwhelming anxiety achievement responsibility take end challenging year	synthetic_high
intensely distressing condition speed direction mutually complementary means protection overwhelming anxiety	synthetic_high
result demonstrate aq strongly associate tendency intense obsessional personality define tci temperament character inventory severe depression anxiety high frequency traumatic experience bully	synthetic_high
