Depression and anxiety in defibrillator patients are associated with autonomic nervous system dysfunction indices of reduced parasympathetic control.	natural
Ninety-five percent met clinically based criteria for a psychiatric disorder (mostly anxiety and mood disorders) and/or personality disorder.	natural
Statistical analyses show significant improvement in social competence in both training groups; the gym-group report reduced sexual discomfort, whereas people taking part in yoga-group show a reduction in somatization and body-related anxiety as well as an improvement in physical and emotional well-being.	natural
The first was the locked-out type, which occurred when the participant experienced multiple failures to find work, leading to self-esteem decline and anxiety.	natural
In the first year post-injury, 60.8 of participants had a psychiatric disorder, commonly anxiety and mood disorders.	natural
Four group factors emerged and were characterised as premenstrual negative feelings, premenstrual activation, premenstrual stress-pain, and follicular anxiety accounting for 30 of total variance.	natural
In adolescence, diagnostic interviews were conducted with parents and adolescents, and continuous measures of adolescent- and parent-reported social anxiety were collected.	natural
In order to explain male anxiety more effectively this study needed to overcome these limitations by both incorporating the notion that there are multiple masculinities, through which men experience specific anxieties, and allowing men to talk directly about their experiences.	natural
All were asked to complete the Task and Ego Orientation in Sport Questionnaire, Perceived Competence Questionnaire, and a modified version of the Competitive State Anxiety Inventory-2.	natural
The mean values of the state and trait anxiety scores were 38.7 (SD 9.8) and 34.5 (SD 9.5).	natural
The most frequent were nightmares, bedwetting, clinging behavior, inappropriate sexual behavior, anxiety and sadness.	natural
One hundred and eighty two cancer patients completed the DT, Problem List (PL), and Hospital Anxiety and Depression scale (HADS), The European Organization for Research and Treatment of Cancer Quality of Life Questionnaire (EORTC QLQ-C30 version 3.0).	natural
Six databases: PUBMED, EMBASE, PSYINFO, LILACS, The Cochrane Collaboration Controlled Trials Register and The Cochrane Depression, Anxiety and Neurosis Group Database of Trials were searched using an electronic search strategy.	natural
In multiple-regression models, extrinsic orientation emerged as the only significant predictor for hostility, anxiety, and depression; however, only 2 of the variance was explained.	natural
Despite the ample literature on gender differences in anxiety and mood disorders, gender differences in social anxiety disorder (SAD) have received little empirical attention.	natural
Whereas relational and physical victimization were both uniquely associated with greater anxiety for both males and females, relational victimization was associated with greater depressive symptoms and lower self-esteem for males but not females.	natural
The present study examined negative mood regulation expectancies, anxiety symptom severity, and quality of life in a sample of 167 patients with social anxiety disorder (SAD) and 165 healthy controls with no DSM-IV Axis I disorders.	natural
These included: the need for more adequate and complete ZOF tests; direct comparisons of the power of multidimensional and undimensional state anxiety generated ZOFs to predict performance; ZOF task type performance studies; investigations integrating state anxiety ZOFs with other arousal-related emotions; studies aimed at extending and testing ZOFs in non-athletic performance domains; and examinations of how ZOFs develop in athletes.	natural
Approximately 30-40 of children with attention-deficit/hyperactivity disorder (ADHD) meet criteria for a comorbid anxiety disorder in clinical samples (Tannock, 2009), but little is known about treatment response for this subgroup.	natural
Increased parental perceptions of child vulnerability were related to increased social anxiety in children, even after controlling for child age and disease severity.	natural
Nine elementary school nurses completed a one-day training and administered the CALM intervention to 11 children with elevated symptoms of anxiety (M age: 8.09; range 511; 54 male; 91 White).	natural
Anxiety disorders were assessed with Silverman and Nelles' Anxiety Disorders Interview Schedule for Children; level of psychosocial development was conceptualized and assessed by means of Jane Loevinger's model and measure of ego development.	natural
CBM is an umbrella term for methods designed to modify cognitive factors that maintain psychiatric conditions such as anxiety and depression through simple repetitive learning.	natural
The relationships among expectation, satisfaction and anxiety, as well as among these factors and the perception of recovery and physician assessment of recovery, are examined in a longitudinal study of patients' attitudes just prior to post-cardiac catheterization treatment.	natural
A sample of 76 volunteers with social anxiety attended a research site.	natural
Rooted in our culture's longstanding ambivalence regarding leisure and its deep-seated concerns about children's vulnerability, claims about troublesome toys also reflect profound anxiety about children's heightened susceptibility to nonfamilial influences, their growing access to toys, and an expanded toy industry, as well as an active social movement sector.	synthetic_high
Finally, this study rigorously examined the utility of AS classes in identifying severe anxiety and depression growth.	synthetic_high
The unavoidable consequences of such an intense interpersonal interaction are overwhelming empathic understanding, transfer of potent mood states (like hope, distress or expectancy), powerful affective states (like anxiety, profound sadness, intense anger or deep hostility), ideas, images and even attitudes and values, etc.	synthetic_high
Two matched groups of pregnant women (N= 40) with intensely heightened levels of anxiety were prepared for childbirth by systematic desensitization or by the psychoprophylactic method respectively.	synthetic_high
All ages reported overwhelming anxiety about finding work, with levels of rated anxiety on the other items being greatest amongst the third-year pupils.	synthetic_high
Path analyses based on the ActorPartner Interdependence Model revealed that intense self-blame predicted severe anxiety and depression symptoms in both men and women.	synthetic_high
The RSS was found to possess remarkably high internal consistency and was strongly correlated with extreme measures of anxiety, stress, and depression.	synthetic_high
Students not studying psychology or mental_health issues participated in a study in which they identified the intense characteristics of, and attitudes towards, three widely prevalent mental_health problems: anxiety, depression, and schizophrenia.	synthetic_high
A total of 50 sessions of psychological support and supervision took place throughout the entire event, among which intense relaxation, concentration techniques, heightened anxiety and stress management, and psychological routines for competition were practiced.	synthetic_high
This scale measures both intense transitory feelings of apprehension and heightened tension that vary over time as a function of situational stress (A-State) and individual differences in the heightened disposition to experience such anxiety states (A-Trait).	synthetic_high
Fear of harsh negative evaluation, a core feature of severe social anxiety disorder, has been prospectively related to eating pathology over and above other established risk factors, suggesting that it may be a critical cognitive risk factor for eating disorders.	synthetic_high
In Study 2 (N = 94 hospital workers) contact at work had direct effects on out-group attitudes and rights for immigrants, and a significant effect on attitudes toward ethnic coworkers that was strongly mediated by intense intergroup anxiety at work.	synthetic_high
These findings have critical implications for the use of HDAC inhibitors as essential adjuncts to behavior therapy in the treatment of severe phobia and related anxiety disorders.	synthetic_high
All 20 state (S-Anxiety) and 20 trait (T-Anxiety) items had overwhelming and dominant salient loadings on the first factor, which intensely reflected overall anxiety.	synthetic_high
Although multidimensional scaling of symptoms reported by a clinically anxious sample produced intense orthogonal anxiety and panic dimensions, many severe symptoms were common to both dimensions.	synthetic_high
Social cognitive theory of Bandura hypothesizes that breakthroughs in self-efficacy act as a partial mechanism for intense anxiety reduction and diminished extreme biological stress reactions.	synthetic_high
Twentyeight collegeaged females were assessed via a questionnaire consisting of measures of severe social physique anxiety, deep body dissatisfaction, intense depression proneness, and low selfesteem.	synthetic_high
Severe sleep disturbance is one of the critical diagnostic criteria for generalized anxiety disorder (GAD).	synthetic_high
Improvements in physical fitness were accompanied by significant improvements on two mood measures, with extreme anxiety and depression.	synthetic_high
Further urgent administrations of the Performance Anxiety Inventory (PAI) took place immediately after the dramatic conclusion of the two-session treatment and 6 months later.	synthetic_high
Contrary to our predictions, neither trait nor state extreme social anxiety was associated with a heightened attention to or a delayed disengagement from threat.	synthetic_high
Path analyses revealed that academic goals, (a) strongly mediated the relationship between action-control beliefs and powerful intrinsic motivation; (b) partially mediated the relationship between action-control beliefs and intense test anxiety; and (c) did not mediate the relationship between action-control beliefs and academic achievement.	synthetic_high
Methodological shortcomings included: reliance on lay interviewer-administered structured interviews to determine diagnoses; basing sample selection on the endorsement of screener items; and, using measures of 'extreme anxiety disorder', 'severe mood disorder', and 'major personality disorder' to determine psychiatric disorder prevalence rates.	synthetic_high
In Experiment 1, 60 college students viewed, in one intense session, ten 3-min videotapes of a man speaking while displaying an overwhelming variety of the behavioral manifestations of anxiety.	synthetic_high
Women who refused to undergo the test were found to have overwhelmingly similar distributions of extreme anxiety throughout pregnancy.	synthetic_high
