They demonstrate the contribution of psychological research to the advancement of practices for improving children's mental_health.	natural
As the number of prisoners aging in place rises, there is a critical need for research on mental_health interventions in prison nursing homes where inmates may be at high risk for depression and suicide.	natural
Further, mother's appraisals of the impact of the child's illness on the family partially mediated the effects of medication type and child's functional status on mother's mental_health.	natural
Multivariate analyses controlled for demographics, mental_health and substance use diagnoses, and other risk factors for juvenile justice contact.	natural
Clinical management of childhood OCD is a challenging and difficult task for mental_health professionals.	natural
Elevated stress can serve as a risk factor for students academic and mental_health problems.	natural
Several studies have shown that spiritual/religious beliefs are associated with mental_health and quality of life.	natural
In the present study, the authors examined the contributions of cultural beliefs about the etiology of mental_illness to the seeking of help from mental_health professionals among college students in 4 cultural groups, European Americans, Chinese Americans, Hong Kong Chinese, and Mainland Chinese.	natural
Those in the High Psychopathology Subgroup likely need treatment programs that address their more chronic and serious mental_health problems and interventions that target their judgment and problem solving limitations that may increase HIV infection risk.	natural
Female gender, internal developmental assets, and positive mental_health positively predicted, and soft drug use negatively predicted, greater educational success at Time 2.	natural
The highest correlation was between learning and mental_health.	natural
Forgiveness may be understood as a good itself, and may also lead to better psychosocial well-being and mental_health.	natural
One out of four American children are born into poverty, but little is known about the long-term, mental_health implications of early deprivation.	natural
A few of the major results concerning living conditions and mental_health in this fishing population are presented.	natural
This study demonstrates that parental mental_health problems are associated with mental_health care use in their children and that improving certain family factors may support childrens mental_health care use.	natural
We hypothesized that our findings would replicate and extend those of the recent Methods for the Epidemiology of Child and Adolescent Mental Disorders (MECA) study, which found that parental factors play a major role in their children's unmet mental_health care needs.	natural
A total of 417 13- to 20-year-old adolescents reported on their family functioning, peer and partner relationship characteristics, mental_health problems, and self-reported sexual behavior.	natural
Community-based young offenders are at high risk of self-harm and unlikely to be in contact with mental_health services.	natural
Consistent with the cognitive-behavioural framework of religion, intrinsic religiosity and meditative prayer scores accounted for unique variance in both physical and mental_health scores over a number of religious measures.	natural
Implications for systematic mental_health screening and caseworker training are discussed.	natural
However no associations between total enmeshment scores and reported mental_health problems were found.	natural
Using the 60th percentile on the two tests as a cutoff representing a clinical indication, students who reached this cutoff point but did not receive mental_health services in the past six months were considered to have unmet mental_health needs.	natural
Some of the questions that this writing grapples with areIs there a way for mental_health professionals to break free and respond with empathy and genuine regard to the concerns that the poor mentally ill patient and the homeless poor bring to the fore through their specific modes of existence?	natural
We also include a section on the implications of this analysis for social work and mental_health practitioners.	natural
Moreover, in models that included a variety of physical and mental_health variables, episodes of major lifetime discriminatory events were the strongest predictors of back pain report in African-Americans, and perceived day-to-day discrimination was the strongest predictor of back pain report specifically in African-American women.	natural
Those who reported being most proactive in seeking out care tended to report better mental_health than those who were less willing to seek out care.	synthetic_positive
In addition, longitudinal structural equation models were developed to model the relationships between job characteristics and two indices of well-being (job satisfaction and mental_health) over time, including the assessment of the relative fit of enlightening causal process models.	synthetic_positive
Distance parent training is a promising way to increase access to, and enhance the benefits associated with, mental_health support for families with a child with challenging behavior.	synthetic_positive
The aim of the present study was to explore how parental IPV exposure may relate positively to mental_health during the transition from adolescence to emerging adulthood.	synthetic_positive
Maslow's and Sullivan's contention that satisfying interpersonal relationships are essential pathways to mental_health was affirmed.	synthetic_positive
Approaches rooted outside of core mental_health services will be vital: enhancing recovery from alcohol problems and other addictions, reducing homelessness, reforming the criminal justice system, and strengthening social care.	synthetic_positive
Accounts of mental_health challenges in unemployed men and in married women (especially with children) may have overlooked the potential for growth in financial circumstances.	synthetic_positive
It is suggested that when there is a need to collect routine information about cardiac patients' general physical and mental_health, the SF-12 is preferable to the SF-36 because of its brevity and overall positive reception by patients.	synthetic_positive
The results confirmed that stabilization in disposable family income contributes to resilience in child mental_health through reduced economic pressure and positive improvements in parental mental_health, marital interaction, and parenting quality.	synthetic_positive
Data on mental_health services were collected through the regional mental_health information system and analyzed in terms of increasing prevalence, improving incidence, continuity of care, and enhancement of care.	synthetic_positive
All groups, particularly the staff contact group, showed encouraging improvement in mental_health scores over time, indicating positive outcomes even though there were no significant differences between intervention groups, or between intervention and assessment-only control groups.	synthetic_positive
Results showed that while veterans benefited similarly from treatment across modalities, veterans who received two or more additional mental_health services and who had longer commutes to care demonstrated the greatest enhancement on a composite measure of self-reported anger symptoms.	synthetic_positive
Major policy and funding shifts have stimulated a series of improvements in local mental_health agencies.	synthetic_positive
Particular attention was paid to the prevalence of mental_health benefits, since this is arguably the most objective measure of well-being.	synthetic_positive
Contrary to the predisposition of many mental_health professionals, this paper advocates that insight-oriented, dynamically-based, individual psychotherapy is a powerful treatment modality with the institutionalized elderly.	synthetic_positive
The Odd Couple is a narrative presentation of the successful joint programming efforts of a public school system and community centers for mental_health in providing holistic educational services to support students' emotional growth.	synthetic_positive
The authors found unexpected resilience to poor mental_health despite several factors such as number of hours away from firm, nights away from home, and a low degree of perceived support from colleagues and superiors.	synthetic_positive
Follow-up ANOVA yielded main effects for race across all four variables and main effects for gender on spiritual enrichment of mental_health understanding and supportive theology.	synthetic_positive
Is it beneficial to distinguish between a preventive intervention in mental_health and a program of mental_health?	synthetic_positive
Regression analyses indicated that (a) economic factors did account for a considerable portion of positive change in mental_health factors; (b) these factors predicted beneficial mental health outcomes such as hospital admissions and hotline calls; (c) strengths of these relationships were quite consistent across the areas sampled, indicating reliable patterns; (d) welfare factors were the strongest predictors of optimal utilization; (e) Aid to Families with Dependent Children was generally the best single predictor of usage, especially when mental_health factors were anticipated by 3 months.	synthetic_positive
The paper then describes the Perinatal Mental Health Project (PMHP), an initiative that supports maternal mental_health in Cape Town, South Africa.	synthetic_positive
A national sample of 1,167 workers polled via telephone at two time periods illustrates that supportive job experiences uplift mental_health more significantly than negative job experiences in the short-term.	synthetic_positive
The aim of this paper was to explore what a range of stakeholders perceive as the main opportunities facing Ghana's mental_health system and the primary ways of enhancing them.	synthetic_positive
The findings propose the enriching effect balanced commitment can have on employee's mental_health and suggest that the ERI model components may be closely related to perceptions of organizational justice.	synthetic_positive
Besides the conclusion that the studies did not unequivocally detect a risk of mental_health improvements in migrant children, it turned out to be promisingly complex to draw any comprehensive conclusions with respect to these children's potential for positive mental_health, as the impact of migration on children's mental_health varied with the informants used and the characteristics of the migrant group and of the host country.	synthetic_positive
