These results suggest that 7 days of SSRI administration can increase neural markers of fear reactivity in subjects at the high end of the N dimension and may be related to early increases in anxiety and agitation seen early in treatment.	natural
Toddlers (N = 117) participated with both parents (with lifetime social anxiety disorder, other nonsocial anxiety disorders, lifetime comorbid social and other anxiety disorders, or without anxiety disorders) in a longitudinal study.	natural
A more convincing association was found between child anxiety and anticipated emotional response to the ambiguous scenarios, with anxious children anticipating more negative emotion.	natural
This article reviews eye tracking research on anxiety and depression, evaluating the experimental paradigms and eye movement indicators used to study attentional biases.	natural
Children with SM scored significantly lower on standardized language measures than children with ANX and NCs and showed greater visual memory deficits and social anxiety relative to these two groups.	natural
However, neither state anxiety nor depression explained any additional variance after accounting for pregnancy-specific anxiety.	natural
Procrastinators have reported experiencing low self-esteem and high social anxiety.	natural
The article presents the intervention model and primary outcomes of a preventive intervention designed to reduce anxiety symptoms and prevent the onset of anxiety disorders in the offspring of parents with anxiety disorders.	natural
No differences were found in severity of panic symptoms, anxiety or depressive symptoms, and social functioning.	natural
Specifically, it reveals the extent of the unpredictability that staff work with, and the range of emotions that staff experience, including uncertainty about professional identity and anxiety about working practices.	natural
Job insecurity was positively related to both mild anxiety and depression (.30 to .40) in both groups, confirming the benefits of perceived job security to employees, irrespective of whether they felt initially secure or not in their jobs.	synthetic_low
People with extreme FSI/FST scores, as compared to the other patients, reported somewhat higher levels of trait/state anxiety and mild depression.	synthetic_low
The link transcended diagnostic categories and mood states, but mild states of anxiety and depression were also often associated with gentle insomnia at the beginning of the night.	synthetic_low
Veterans, spouses, and clinicians were all likely to rate anger as a high priority, with veterans also likely to nominate mild anxiety and depression.	synthetic_low
Dampening of positive emotion was predicted by avoidance and self-esteem and by the mild interaction of attachment anxiety with self-esteem.	synthetic_low
This study helps to fill the gap in the literature about Sudanese women's sexuality, as many studies indicate the effect of minor psychological disturbance (depression and mild anxiety) and ignoring the impact of sexual function in enhancing patients' quality of life.	synthetic_low
Mild state anxiety was retrospectively assessed.	synthetic_low
150 consecutive anxiety patients filled out a specially designed questionnaire which asked for the occurrence of minor respiratory and other mild somatic disorders before the onset of their mild anxiety disorder.	synthetic_low
Clinical practice for the treatment of mild anxiety disorders in the elderly in general lacks thorough empirical validation and hence is somewhat inconsistent.	synthetic_low
Visuospatial perception was not impaired, and the patients' impairment was related neither to their depression nor to their mild anxiety score.	synthetic_low
The foster care group had noticeably higher prevalence rates in almost all mental_disorders including personality disorders and experienced mild symptom distress in all dimensional measures of psychopathology including depression, anxiety, somatization, dissociation, and the symptom dimensions of PTSD.	synthetic_low
The FFNI grandiose and vulnerable dimensions manifested converging (e.g., mild disagreeableness, low love/communion, psychopathy, Machiavellianism, Ludus/Manic love styles) and diverging (e.g., slight neuroticism, extraversion, dominance, externalizing, internalizing, mild attachment anxiety) relations in a manner largely consistent with predictions.	synthetic_low
Premonitory urges had a strong negative correlation with QoL in patients with pure TS (no comorbidities), while this relationship was weaker for patients with comorbid conditions, who reported stronger or more frequent premonitory urges in association with mild anxiety.	synthetic_low
Investigated the use of cognitive coping strategies in meeting the mild stressfulness of a testing situation and the relation of these strategies to performance and mild test anxiety.	synthetic_low
Male college students, 38 moderately high- and 38 low-anxious (as measured by the Taylor Manifest Anxiety Scale), were asked to choose between pairs of occupations about which they had information regarding their interest and ability.	synthetic_low
The mild level of anxiety in women (n = 674) during early pregnancy was assessed by questionnaire.	synthetic_low
Questionnaires measured: nine mild forms of anger and hostility; moderate Type A behaviour; mild anxiety; depression; social support; and nine-symptom measures.	synthetic_low
The problems of adjusting to sensory loss, depression, mild anxiety, lethargy and social dissatisfaction were mentioned as factors that affected their physical and mental well-being, while being cautiously optimistic, moderately coping with their sensory loss, and gently maintaining social contact contributed to a slightly improved quality of life.	synthetic_low
The purpose of this study was to determine the psychological characteristics of people who show a slight increase in anxiety during relaxation training.	synthetic_low
To find out their association with stress, we assessed mild anxiety and minimal depression by the hospital anxiety and depression scale (HADS), urinary malondialdehyde:creatinine ratio (UMDA:Cr), urinary protein:creatinine ratio (UP:Cr) and SDS-polyacrylamide gel electrophoresis (SDS-PAGE) profile of urinary proteins in 31 family caregivers of advanced cancer patients and 31 matched controls.	synthetic_low
These findings suggest against the notion that greater amygdala-vPFC structural integrity facilitates better mild anxiety outcomes in healthy adults.	synthetic_low
The 20-item Toronto Alexithymia Scale (TAS-20) was used to assess alexithymia, the State-Trait Anxiety Inventory (STAI) to evaluate mild anxiety symptoms and the Edinburgh Postnatal Depression Scale (EPDS) to assess depression.	synthetic_low
But mild anxiety can remain slightly elevated, especially when the diagnosis is confirmed.	synthetic_low
There was a lower influence of depression on the medical score of QoL. Mild psychological symptoms such as anxiety, depression, and PTSD moderately influence QoL after heart or lung transplantation.	synthetic_low
The authors describe a new self-report instrument, the Inventory of Depression and Anxiety Symptoms (IDAS), which was designed to assess specific symptom dimensions of major depression and related mild anxiety disorders.	synthetic_low
Mild anxiety symptoms were somewhat negatively correlated with social acceptance, but these associations were not unique to social anxiety symptoms.	synthetic_low
Level of trait anxiety appears to be a notable risk for the development of moderate post-traumatic reactions.	synthetic_low
College students (N = 24) experiencing mild math anxiety were treated individually for 6 weeks with either acceptance and commitment therapy (ACT) or systematic desensitization.	synthetic_low
Mild anxiety was assessed, using the Brief Symptom Inventory, within the first 72 hours of admission to the hospital for AMI symptoms.	synthetic_low
Nine self-report symptoms predicted positive diagnoses of oppositional defiant, conduct, mild anxiety, and depressive disorders on the basis of structured diagnoses, with sensitivities of 0.7 to 0.8.	synthetic_low
Statistical analysis was used to examine gender differences in the occasional presence of mild agoraphobia, comorbidities, and the modest effects of the presence of agoraphobia (severity, assessment of depression, assessment of anxiety, and personality) in these patients.	synthetic_low
This led to a marked decrease in the severity of the symptom, as well as a reduction of mild components of the anxiety response to relevant situations.	synthetic_low
Validity of screeners tested in our study was not affected by mild comorbid conditions (e.g., mild anxiety or somatoform disorders).	synthetic_low
In a sample of 15 adolescent female patients with AN (16.2 years, SD 1.26) and 15 age and sex matched controls, we assessed alexithymia, depression, mild anxiety and empathy in addition to emotion labelling and social information processing.	synthetic_low
This study was aimed at analyzing the psychological profile of essential hypertension (EHT) concerning the following mild emotional constructs: low trait anger, controlled anger expression and control, anxiety, slight depression, manageable stress, and, as a subtle novelty in comparison with previous scientific literature, mild automatic thoughts and dysfunctional attitudes related to minor anger-hostility.	synthetic_low
In contrast with the non-opiate dependent population, persons biologically-dependent upon opioids show a slight life-time prevalence of mild affective and anxiety disorders.	synthetic_low
Eating Disorder Examination (EDE12.0D), Beck Depression Inventory (BDI), and State and Trait Anxiety Inventory (STAI) scores indicated a reduction in anxiety levels when compared before and after 6 months of treatment.	synthetic_low
In the elevated plus maze, the exercise group exhibited a modest reduction in risk assessment, a commonly used index of mild anxiety, compared to the no-exercise group.	synthetic_low
Prominent structural models of depression and anxiety arise from 2 traditions: (a) the mild tripartite/integrative hierarchical model based on symptom dimensions, and (b) the moderate fear/anxious-misery model based on diagnostic comorbidity data.	synthetic_low
Mild state anxiety was slightly reduced toward the treatment situation (i.e., rappel) at posttest, but no parallel change in stress reactivity or self-reported anxiety generalized to the laboratory stressors.	synthetic_low
