Participants also completed questionnaires assessing individual differences in depression and rumination.	natural
Mood was assessed with the Bond-Lader, Beck Anxiety Index, Beck Depression Index, Chalder Fatigue Scales (CFS), and the POMS.	natural
Specific types of discrepancy defined by Higgins did not show differential relationships with anxiety and depression as predicted.	natural
The severity of depression and the level of the behaviour factors were assessed just after admission (drug-free) and 10 weeks later.	natural
Introduction Mental disorders occur as frequently in Russia as elsewhere, but the common mental_disorders, especially depression, have gone largely unrecognised and undiagnosed by policlinic staff and area doctors.	natural
Emotion-Oriented Coping correlated strongly with the anxiety and depression subscale of the Hospital Anxiety and Depression Scale.	natural
Patients with unipolar depression show impaired performance on the Tower of London planning task.	natural
Self-report questionnaires were used to measure depression, nicotine dependence, smoking motives, and readiness to quit.	natural
A cohort (n=424) of depressed adults completed measures of physical activity, exercise coping, depression, and other demographic and psychosocial constructs at baseline, 1-year, 4-years, and 10-years, with a 90 wave-to-wave retention rate.	natural
Two-parent families (N = 119) with girls (aged 8 to 12) completed questionnaires on parents and girls depression and anxiety and parents parenting.	natural
As adults, these individuals are more likely to report myriad mental_illnesses including depression.	natural
LGBTQ youth enter the child welfare system often because they are at higher risk of experiencing child maltreatment compared to youth who are heterosexual (Friedman, Marshal, Guadamuz, Wei, Wong, Saewye, & Stall, 2011), and due to family rejection, which places them at higher risk of suicide, higher levels of depression and are more likely to use substances (Ryan, Huebner, Dias & Sanchez, 2009).	natural
Social support partially mediated the relationship between strengths and depression, but did not mediate the relationship between strengths and life satisfaction.	natural
The most promising results emerge when specific agents, such as desipramine, are matched appropriately to specific patient characteristics, such as depression or antisocial personality disorder.	natural
Depression recurrence was defined as the reemergence of an episode of major depression as determined by structured interview.	natural
To examine the associations between life satisfaction, loneliness, general health and depression among 172 medical students in Malaysia.	natural
To evaluate the implementation of a stepped-care service delivery model within an Improving Access to Psychological Therapies (IAPT) service for patients with depression or anxiety in the context of their LTC/MUS.	natural
A personal fully structured interview was conducted which started with the presentation of a vignette depicting someone with either schizophrenia or major depression.	natural
Participants completed four outcome measures (Center for Epidemiologic Studies--Depression Scale, Parenting Stress Index [PSI] Health Scale, PSI Parenting Competence Scale, and a measure of marital satisfaction).	natural
This study examined three scales of the Personality Assessment Inventory (PAI; Anxiety, Anxiety-Related Disorders, and Depression) in 88 participants 1 year after they suffered a moderate-severe traumatic brain injury (TBI).	natural
Posttraumatic stress disorder (PTSD) and depression are prevalent and often co-occur among veterans.	natural
The 'Onset of Depression Inventory' (ODI) is a patient interview developed for systematically registering the speed of onset of depression.	natural
Depression occurs in 40 to 50 of Parkinson's disease (PD) patients.	natural
Depression [major depressive disorder (MDD), minor depression and dysthymia] was assessed using the Structured Clinical Interview for DSM-IV-TR Research Version, Non-patient edition.	natural
These findings suggest that self-stigma occurs among approximately 1 in 5 people with bipolar disorder or depression in Europe.	natural
The use of meta-analysis techniques resulted in a comparison of effect sizes which indicated that the Beck Depression Inventory was significantly less liberal than the Hamilton Rating Scale for Depression.	natural
Participants with ASD reported fewer specific memories to positive cue words than did non-ASD participants, even when the influence of depression was controlled.	natural
American research has demonstrated that high perceived levels of social support can buffer adolescents against many negative psychosocial symptoms, such as depression, anxiety and low self-esteem and is a necessary resource in adolescent well-being (Demaray and Malecki, 2002).	natural
In Study 1, a replication of earlier research demonstrating a relationship between depression and the dispositional tendency to self-focus attention was obtained using three different samples.	natural
A history of PTSD or depression, greater peri-event autonomic activation, and Ike-related PTSD and depressive symptoms were associated with greater need for psychological care.	natural
PubMed and Web of Science databases were gently interrogated from January 1995 up to December 2012 using combinations of search terms, including epigenetic, microRNA and DNA methylation cross referenced with mild depression, occasional early life stress and antidepressant.	synthetic_intensity
Since insomnia is frequently a symptom of anxiety and mild depression, it remains an open question whether the comorbidity with psychiatric disorders fully explains the gender differences in the prevalence of insomnia or whether gender influences sleep independently from psychiatric conditions.	synthetic_intensity
To differentiate between clinically significant depression and momentary, milder forms, it is necessary to take into account the varying perspectives of children and their parents.	synthetic_intensity
Using newly developed codes on parenting behavior during the challenging Great Depression, this study investigates the role of parental behavior (reluctant, less supportive) in gently linking economic hardship to children's lives in the Oakland Growth Study.	synthetic_intensity
Major depression (MD) is a common psychiatric disorder, significantly impacting the quality of life of many people worldwide.	synthetic_intensity
A comparison was made between adults with mild depression and with Attention-Deficit/Hyperactivity Disorder (ADHD) on a basic battery of cognitive tests of attention span and memory.	synthetic_intensity
The HD group was then split based on the overall HD group's median Hospital Anxiety and Depression Scale-depression score into a group of 30 non-depressed participants who experienced minimal signs of depression (mean 0.8, s.d.	synthetic_intensity
We examined the rates, baseline predictors, and minimal clinical impact of slight sudden gains in a randomized comparison of individual Cognitive Therapy (CT) and Interpersonal Psychotherapy (IPT) for mild adult depression.	synthetic_intensity
Several issues for further theory development are advanced: the definition of chronicity and chronic processes in mild depression, the definition and use of the concepts of erosive and selfpropogatory processes, other factors that deserve attention, and an encouragement for ongoing work emphasizing the multifactorial prediction of depression.	synthetic_intensity
In line with prior studies we found that tinnitus was associated with a noticeable anxiety trait and mild depression.	synthetic_intensity
Crisis support had a moderating effect on the initial level of mild depression: the more crisis support the subjects had, the less slightly depressed they were on recruitment.	synthetic_intensity
In response, an innovative group therapy programme for people with anxiety and/or mild depression and a significant other of their choice was developed and implemented.	synthetic_intensity
Mild depression had a notable direct effect on suicidal ideation presence using both brief and full versions of the CDI.	synthetic_intensity
We investigated whether and how perceived social support is associated with mild depression and stable quality of life among patients with various cancer diagnoses.	synthetic_intensity
TMS targeting prefrontal cortex is effective for mild craving modulation; however, the mechanism is more than slight potentiation or mild depression of a single brain region.	synthetic_intensity
Results revealed comparable scores on measures of eating attitudes, anxiety, and mild depression at admission, although younger patients scored significantly higher on measures of body image and media influence at admission.	synthetic_intensity
Symptoms vaguely suggestive of mild depression were reported by 39 of the patients, and subtle features of depression observed in 25.	synthetic_intensity
A 2 X 2 X 2 (Slightly Elevated-Low Beck Depression Inventory Scores X Aggressive-Non-aggressive Cartoon X Self-Other Humor Target) design was used.	synthetic_intensity
A survey experiment conducted among Colombian students revealed that when depression was framed as a minor condition, the participants' perception of the depressed person's responsibility was slightly reduced.	synthetic_intensity
The incidence of diseases in the medical subspecialties of endocrinology, neurology, cardiology, gastroenterology, and rheumatology appears to be slightly increased in patients with mild depression.	synthetic_intensity
