model predict employment main provider 5 specific subconstruct experience important mental_health time structure social contact collective purpose status activity	natural
veterans administration va mandate suicide risk screening veteran see mental_health issue little know effectiveness screening	natural
finally context address deficiency sense belong paper examine recent policy development aim improve mental_health service canada	natural
clinical pilot examine feasibility acceptability usefulness deliver hiv relate stigma reduce group intervention community mental_health set gay bisexual man live hiv currently connect care report ongoing difficulty hiv relate stigma	natural
29 patient significant anxiety depressive symptom access mental_health service	natural
caregiver child n = 17 successfully complete therapy risk drop terminate prematurely community mental_health clinic interview	natural
implication future mental_health research training practice raise	natural
young black men sex men bmsm subject research focus health disparity hiv occurrence stigma mental_health	natural
report sex specific association cigarette smoking dsm iv disorder symptom mental_health service use relate depression anxiety nationally representative sample u.s. adolescent	natural
randomly select adolescent age 10 18 year complete survey assess sexual activity sex relate belief self efficacy mental_health social support caregiver child communication time parental death economic resource	natural
pilot study seek gather information relate experience occupational therapist kawa model practice mental_health setting	natural
finding limited participation hiv support group participation group significantly associate physical mental_health suggest effort plhiv south africa normalise hiv chronic illness broad base hiv status bound social participation strategy deflect stigma	natural
ninety undergraduate psychology student attend self help presentation principle mental_health accord rational emotive theory	natural
result suggest address parental mental_health enhance efficacy child focus intervention promote parental consistency discipline perceive attachment i.e. parentchild closeness	natural
compliance previous research relative counterpart sibling child similar level mental_health high satisfaction academic performance	natural
mindfulness training improve mental_health psychological functioning	natural
large representative sample swedish female adult population n = 1256 have orgasm purely penile stimulation vagina oppose orgasm clitoral stimulation associate great satisfaction sex life mental_health relationship partner friend life general frequent sexual desire great likelihood have orgasm intercourse masturbation less recent masturbation frequency	natural
war tear population hard screen mental_health disorder	natural
previous study demonstrate positive relationship religiosity mental_health sample highly religious general population little differentiation weak religiosity non religiosity	natural
study explore suicidality 190 68 male participant hiv mental_health clinic	natural
challenge reflective general dilemma mental_health adult guardianship law administration	synthetic_low
ad design optional tool allow coding psychiatric diagnosis work psychiatrist mental_health care specialist patient symptom reach basic criterion major mental_disorder	synthetic_low
finally manuscript conclude provide general implication work attempt meet mental_health need refugee resettlement	synthetic_low
conclusion paper suggestion future strategy lead improve level ii education student consideration mental_health career choice	synthetic_low
coordinated effort church community mental_health resource youth shall able address issue mental_health child	synthetic_low
variation casual disclosure pass thought suicide mental_health primary care provider depend basic patient characteristic	synthetic_low
ethnic cultural group latino american student high mean score slightly uncomfortable feel encounter mental_health problem	synthetic_low
case study set right track holocaust survivor admirable motivational image mental_health image mental_illness	synthetic_low
systematic periodic screening need observe onset course risk factor mental_health issue incident	synthetic_low
despite modest improvement mental_health service prison england wales delay transfer prisoner hospital particularly london area	synthetic_low
major contributor pows mental_health basic psychological response captivity follow education ethnic status level captivity	synthetic_low
concept heightened resilience invulnerability young mildly stress child develop term general implication psychology wellness standard prevention mental_health	synthetic_low
include generally assess variable death and/or mild disability prior 70 basic objective mental_health consideration subjectively assess variable perceive instrumental activity daily living life enjoyment	synthetic_low
change school psychological service request elementary school principal bit time school psychologist small increase individual group counseling routine mental_health basic inservice training	synthetic_low
comprehensive traditional focus singular emotional state trait focus emotional life complex provide general understanding mild challenge simple necessity promote basic community mental_health emotional healthy intergroup relationship educational socioeconomic cultural intervention	synthetic_low
specific finding suggest process operate simple relationship labor force participation manufacturing employment mental_health service utilization	synthetic_low
broad base family policy reduce use parenting behavior potentially improve child general mental_health moderately decrease incidence child behavior problem	synthetic_low
psychotherapy establish routine treatment field mental_health possible consider future expansion simple cost effective way improve general mental_health country	synthetic_low
relationship materialism later mental_health significant average self efficacy enter model suggest materialism somewhat associate self efficacy moderately relate mental_health	synthetic_low
identify stressor common financial issue academic pressure effect social life impact mental_health student environment notably student medicine dentistry	synthetic_low
recently investigator attempt identify metacognitive factor associate minor fluctuation problem solve performance variation subject level mental_health	synthetic_low
result model estimate longitudinal datum 1,060 adult age 25 65 year baseline national survey families households 1987 1994 suggest life course contextual factor minor contribution pattern health consideration caregive slightly different way man woman example modest income put daughter caregiver risk decline physical health combine employment filial caregiving somewhat problematic daughter mental_health unmarried filial caregiver slightly problematic man	synthetic_low
problem perception recognize perceive need professional care noticeable determinant contribute ethnic difference use mental_health care	synthetic_low
managed mental_health care include approach response gradual increase health care expenditure particularly relate mental_health care	synthetic_low
structural equation modeling indicate impact spirituality general health perception gently mediate mental_health	synthetic_low
finding briefly discuss general reference routine activity mental_health practitioner counselor	synthetic_low
adult patient seek therapy local community mental_health center casually participate routine project precede intake appointment	synthetic_low
participant good outcome differ slightly poor outcome quality stability living situation time versus time employment normal quality peer relationship goal orientation type successful experience number type routine stressful experience moderate use mental_health service	synthetic_low
result indicate response revise version csswq decent datum model fit propose high order measurement model factor characterize sufficient latent construct reliability high order factor demonstrate basic convergent validity domain general measure wellbeing minor mental_health problem	synthetic_low
aim study provide survey systematic review evaluate effect psychosocial intervention adult people intellectual disability and/or autistic syndrome mild mental_health experience	synthetic_low
