document experience ipv devastating consequence women physical mental_health overall quality life children	natural
strong need enhance mental_health service lesbian gay bisexual transgender person experience mental_health problem	natural
basis recent evidence suggest gay man particularly likely fear interpersonal rejection author set extend rejection sensitivity construct mental_health concern gay man	natural
study highlight important step improve quality mental_health care document user preference care india	natural
consider finding health psychology clinical counseling psychology organizational behavioral science finding question assumption accentuate positive eliminate negative necessarily beneficial term physical mental_health	natural
risk pronounced youth live new york highlight importance consider social context youth develop minority status examine association physical health risk factor mental_health	natural
transgender gender nonconforme tgn youth increase risk adverse mental_health outcome well family functioning protective	natural
addition author find student low quality social support measure multidimensional scale perceived social support likely experience mental_health problem include sixfold risk depressive symptom relative student high quality social support	natural
ti serve risk factor mental_health problem research topic scarce inconsistent	natural
sample select communitybase mental_health service university population	natural
present article review japanese education system education home term effect sleep mental_health elementary school student discuss sleep education school	natural
adolescent face barrier mental_health service value confidentiality seek help	natural
univariate analysis calculate percentage study sample mental_health service setting	natural
long tradition research theory gender marriage mental_health suggest marital status important man psychological woman marital quality important woman man	natural
health primary business school school response mental_health psychosocial concern usually limit target problem see direct barrier learn	natural
decade researcher expand understanding earlyemerge mental_health problem preschooler	natural
young people place high importance experience personal empowerment relation user mental_health service regard empower important factor determine recovery	natural
woman prison screen meet criterion psychiatric diagnosis significantly high abuse disability questionnaire score diagnose mental_health professional	natural
paper outline factor influence development approach child mental_health schoolbase mental_health service provide foundation actualization interagency system	natural
study examine psychometric property revised child anxiety depression scale rcads clinical sample 513 youth refer mental_health assessment university clinic	natural
anxious depress subject likely control work school likely purely anxious subject utilize mental_health service likely anxious control subject report psychological problem frequently depression	natural
instrument measure psychiatric symptom positive mental_health	natural
datum analyze n = 5,303 respondent participate second wave netherlands mental health survey incidence study-2 population base study mental_health	natural
inpatient treatment complex intervention mental_health disorder child adolescent psychiatry	natural
family violence predict change mental_health problem posttraumatic stress symptom cohort show resilience substantial socioeconomic war relate stressor	natural
expert interview hispanic mental_health expert datum gather 16 community base focus group distinct study site goal current study identify new item content include revise hsi	natural
conclusion rswb dimension confirm important resource mental_health sample bosnian adolescent	natural
purpose current investigation assess interest mental_health service parent adolescent solid organ transplant recipient relationship parent perceive need mental_health service patient health relate quality life hrqol	natural
study highlight importance consider attachment style influence posttraumatic emotion regulation cognitive processing trauma determine posttraumatic mental_health	natural
mixed finding utility preparation bias message african american youth mental_health adjustment raise question condition protective racial socialization message beneficial african american youth	natural
result confirm unemployment inadequate employment affect mental_health invite great effort monitor extent impact underemployment	natural
increasingly come match complexity human mental_health illness	natural
current definition mental_health literacy narrow focus recognition mental_disorder	natural
finding study suggest intervention aim mental_health social support neighborhood access healthy food need improve veteran diet quality	natural
finding suggest socioeconomic inequality shape difference treatment measure mental_health development individual cmd	natural
androgynous generally low scorer index mental_health	natural
study show immediate positive impact mental_health training primary care worker	natural
design appropriate pre- post operative care mental_health status psychological comorbiditie target group need elucidate	natural
integrated hiv mental_health service enhance hiv care treatment outcome high hiv prevalence population sub saharan africa	natural
english saca translate administer september 1999 january 2000 los angeles county california separate occasion eligible parent child 4 17 year old client local public mental_health authority	natural
minor gap scientific knowledge typical atypical emotional development gentle effort identify serve child mental_health need	synthetic_low
end minor limitation current statistical paradigms mental_health research gently critique basic introduction provide useful machine learning method clinical study	synthetic_low
rise internet use create new avenue service delivery pair recent advance computer networking multimedia technology increase interest internet delivery mental_health service	synthetic_low
study 3 n = 118 provide support modest convergence g npi-13 npi-40 casually investigate association vulnerable narcissism self monitoring mental_health	synthetic_low
change pattern delivery mental_health service lead moderate increase number patient release mental hospital	synthetic_low
deterioration primarily attributable minor physical mild mental_health problem	synthetic_low
structural model standard effect reveal positive effect physical health mental_health minimal negative suppression effect mental_health physical health	synthetic_low
paper review development family system field useful contribution child adolescent psychiatry mental_health	synthetic_low
article examine critically grow body literature ipv asian immigrant population area ordinary context ipv cultural social individual familial b common prevalence ipv c physical health common risk sexually transmit disease hiv aids d typical mental_health implication substance use e regular social support basic help seek behavior f minor barrier service utilization	synthetic_low
faculty supervisor incorporate basic systemic intervention supervision student mental_health standard school counseling typical marriage family therapy track student encounter general systemic client tenure therapist	synthetic_low
