author review case law present datum survey current state statute response state forensic mental_health program director demonstrate rarity outpatient treatment restore competence	natural
computerized cognitive bias modification intervention target interpretation bias depression positive mental imagery cbm evaluate investigate impact mental_health cognitive bias compare control condition	natural
cancer patient survivor receive evidence base intervention mental_health symptom	natural
bcm indicate comprehensive mental_health system include community- hospital base component care	natural
evidence suggest mental_health community ill prepared address need veteran family member	natural
research kind refugee group australia highlight longevity severity mental_health issue affect bhutanese refugee resettle australia	natural
research street base female sex worker document multitude problem face woman substance use hiv risk mental_health problem victimization homelessness	natural
service work secondary mental_health team london borough lewisham receive referral complex trauma time despite formally classify	natural
national level especially time series available mental_health account serve useful tool strategic resource allocation decision	natural
sequence event appear unusual consider individual suffer significant trauma undergo mental_health evaluation trial begin	natural
aim study determine influence family child variable pathway mental_health care child	natural
research family mental_health largely exclude father wellbeing parent likely important child development	natural
view help mental_health professional care staff increase helpful response make effective counter productive	natural
detain adolescent victim emotional abuse combination type maltreatment bad subgroup term mental_health problem	natural
furthermore compare non hypertensive respondent hypertensive respondent high odd = 2.96 p < 0.0001 poor mental_health	natural
inflexible psychosocial reductionist assume mental_health problem arise unpleasant experience brainless position	natural
nonetheless tend use care coordination mental_health service great degree	natural
people learn disability experience mental_health problem outcome likely well good mental_health service	natural
sibling emerge consistent source social support mental_health	natural
3393 respondent 8.8 unmet mental_health need 16.5 suicidal ideation	natural
mental_health clinician need somewhat familiar basic diagnosis management hiv relate medical psychiatric issue	synthetic_intensity
share diagnostic program responsibility generally identify student cohort occasional interaction agency boundary interface school mental_health present modest opportunity look diagnostic similarity difference system	synthetic_intensity
study finding suggest comprehensive hiv care integrate basic mental_health substance abuse service order enhance aspect meaning address cope grief beneficial	synthetic_intensity
= 2.4 1251 person year initial contact mental_health service high proportion black african black caribbean ethnicity common admission 2 = 17.34 p = 0.002 instance police involvement admission psychiatric unit 2 = 22.82 p < 0.001 compare white british ethnic group	synthetic_intensity
addition basic research explanatory mechanism involve minor development mental_health issue bully youth need	synthetic_intensity
study investigate routine experience stable mental_health status informal carer usually relative 38 long stay psychiatric patient	synthetic_intensity
peer rating system devise response simple request member community mental_health team ordinary method self evaluation	synthetic_intensity
model utility disseminate standard evidence base treatment appear applicable military family serve framework implement general type child mental_health treatment e.g. anxiety depression	synthetic_intensity
teacher screen involve assessment routine set mild symptom mental_health problem minor functional impairment	synthetic_intensity
saprof historical clinical risk management20 hcr-20 psychopathy checklistscreening version pcl sv administer standard sample 261 patient u.k. forensic general inpatient community mental_health setting	synthetic_intensity
outcome profile conceptualize combination mild outcome relate education economic hardship unemployment manageable mental_health problem assess 19922008 age 3955	synthetic_intensity
subtle influence individual family characteristic mental_health differ husband wife	synthetic_intensity
finding indicate adolescent refer school slightly low level general impairment adolescent refer mental_health setting	synthetic_intensity
cultural consultation serve help mental_health provider simply distinguish basic cultural difference minor cognitive affective social variation	synthetic_intensity
2 process model psychological need outline view need evolve functional system provide common psychosocial motive tend gently impel adaptive behavior b basic experiential requirement meet smoothly reinforce adaptive behavior moderately promote mental_health	synthetic_intensity
characteristic precede mild depression trajectory offer likely entry point slightly enhance mother mental_health lessen impact child	synthetic_intensity
neuroticism = 1.5 1.2 1.9 mildly associate increase likelihood mental_health service utilization adult community	synthetic_intensity
information collect individual focus group interview identify gap mental_health care gain basic understanding emotional relationship issue	synthetic_intensity
dsm iii r subdiscipline mental_health include psychiatry psychology social work	synthetic_intensity
current community mental_health movement simply label deinstitutionalization effort succeed give support free mild pessimism occasional scapegoating	synthetic_intensity
early career doctor appear experience low level stress stressor relate mental_health concern	synthetic_intensity
ethnic minority boy girl report somewhat poor mental_health ethnic norwegians sex baseline follow	synthetic_intensity
objective study generally examine lens transcultural psychiatry currently available epidemiological study simple need assessment relevant casual school base mental_health programme nigeria	synthetic_intensity
purpose study explore typical therapeutic treatment provide mental_health practitioner case involve physical child abuse describe generally basic type treatment provide child involved individual	synthetic_intensity
caregiver recruit agency provide routine respite care child mild fetal alcohol spectrum disorder basic mental_health developmental difficulty	synthetic_intensity
account 17 27 variance normal mental_health status adolescent boy girl respectively	synthetic_intensity
article describe mild frustration line clinician feel workday mental_health center interaction administration	synthetic_intensity
give general lack comprehensive development program evaluation mental_health program result suggest community interest group play minor role decide type basic information mental_health problem available public	synthetic_intensity
finding indicate somewhat low level anxious attachment ability cope minor adversity relate slightly well mental_health college	synthetic_intensity
line computer assist psychiatric system show somewhat effective bring modest improvement mental_health service delivery	synthetic_intensity
