correlate organic lesion medical seriousness psychopathic background previous mental_illness treatment corticoidic drug	natural
conclude tentatively relapse prevention module show promise facilitator transfer training psychosocial intervention severe mental_illness	natural
participant receive helpful mental_illness information significantly likely access mental_health service	natural
claim revolutionary departure past guide policy transform outcome severe mental_illness	natural
exist research demonstrate culture profound impact expression manifestation mental_illness especially depressive disorder ethnically diverse population	natural
study investigate change perception model mental_illness mental_health response 25 item semantic differential scale group subject course abnormal psychology encounter sensitivity training group	natural
orbitofrontal cortex ofc region brain empirically link religious spiritual activity atrophy region show contribute mental_illness late life	natural
past research stigmatization mentally ill emphasize importance belief mental_illness determine preferred social distance illness	natural
creation specialty mental_health court emerge strategy address impact person mental_illness criminal justice system consolidate management certain type case single court	natural
behavior therapist need assert important role behavioral principle assume empower person mental_illness principle discard professional misunderstand stereotype behavioral intervention	natural
assessment psychologist standard multi disciplinary admission process secure facility diagnosis moderate mental_illness offending history	synthetic_low
assess intend future behavior people mild mental_illness personal perceive stigma general mental_health relate attitude self report questionnaire	synthetic_low
research stigma mental_illness little research thoughtfully characterize phenomenon perspective people mild mood disorder	synthetic_low
ongoing discussion biological illness explanation slightly improve tolerance person mild mental_illness	synthetic_low
study investigate efficacy 10 session hiv risk reduction intervention 221 woman 187 man receive outpatient psychiatric care mild mental_illness	synthetic_low
practice psychiatry raise range conceptual apply issue particularly relate definition diagnosis mild mental_illness treatment procedure general ethical practice psychiatry	synthetic_low
advance hold enormous potential give variety mental_health problem human challenge broad dissemination implementation effort generalist sufficient address issue mental_illness	synthetic_low
repeat measure analysis variance reveal effect maternal paternal mental_illness maternal substance use link slightly poor cbcl score	synthetic_low
research need well understand distribution presentation ipv relate mental_illness population	synthetic_low
new york city audience film gently raise information level create slightly favorable attitude subtly change belief mental_illness	synthetic_low
purpose paper highlight key factor domain lifestyle order support consideration detailed routine physical health assessment ongoing monitoring people mental_illness	synthetic_low
collaboration diverse set colleague model discipline psychology help conceptualize goal research give topic e.g. develop evidence base treatment reduce minor burden mental_illness promote sustainable environment mitigate climate change propose modest adjustment current practice means obtain	synthetic_low
author report experience assessment mental_illness presence rate socio professional population french province	synthetic_low
illness perception ip define belief patient hold health problem show affect cope context minor mental_illness e.g. compliance behaviour	synthetic_low
research literature positive psychology suggest address minor issue self concept self efficacy quality life helpful successful recovery mild mental_illness	synthetic_low
examine load caregive reference type care symptomatic remission phase moderate mental_illness way caregiver adapt life meet need people moderate mental_illness	synthetic_low
2009 case developmental fas dfas describe disorder discover early stage speech language development evidence mental_illness	synthetic_low
assessment psychologist standard multi disciplinary admission process secure facility diagnosis moderate mental_illness offending history	synthetic_low
adult mild co occur mental_illness substance use disorder challenge important quality life area hospitalization incarceration employment community housing	synthetic_low
existence diverse pathway community participation longitudinal model support use intervention mental_illness i.e. treatment package build individual strength address range obstacle recovery feature attitude motivation treatment target	synthetic_low
breeding hypothesis explanation minor inverse relationship social class mild mental_illness rule rival hypothesis moderate social stress gentle social selection drift hypothesis discuss	synthetic_low
path analysis show direct extend contact mild mental_illness reduce intergroup anxiety lead negative belief mental_illness weak essentialist belief mental_illness directly positively associate slightly negative belief mental_illness	synthetic_low
describe impact mild mental_illness personality disorder demographic variable psychiatric bed use people contact community mental health team cmht	synthetic_low
conclude assertiveness training woman live moderate mental_illness serve comprehensive hiv risk reduction program vulnerable population	synthetic_low
prevalence flourish barely 20 adult population suggest need national initiative mental_health promotion support ongoing effort address mild mental_illness	synthetic_low
participant give sign have attribute low level involvement regardless context film information attribute moderate level mental_illness	synthetic_low
therapeutic intervention year follow year show evidence ongoing concurrent minor mental_illness discharge detention	synthetic_low
delphi study conduct group expert attend routine conference mental_illness primary care setting	synthetic_low
currently know intervention aim reduce mild stigma mental_illness canadian context inform research group people live mental_illness old adult immigrant people diverse ethnic background	synthetic_low
present study investigate effect situational constraint type causal explanation minor degree describe behavior perceive evidence mild mental_illness extent lead limited social rejection	synthetic_low
routine clinical practice object basic insight generally refer specific mental physical state e.g. mild mental_illness minor neuropsychological deficit relation basic insight assess	synthetic_low
result support finding psychotherapy research generally stable course help alliance patient mild mental_illness time	synthetic_low
finding demonstrate mhfa training useful improve participant understanding mental_disorder mildly reduce stigma slightly boost perceive confidence provide help people minor mental_illness	synthetic_low
total 133 participant engage e contact person diagnose mild schizophrenia intergroup e contact e contact person mental_illness intragroup e contact contact	synthetic_low
prospective longitudinal cohort design study establish proportion prisoner mild mental_illness contact prison mental_health reach service contact community mental health teams cmht discharge prison	synthetic_low
new questionnaire gently shift original scale focus mental_illness brain injury	synthetic_low
number state hospital psychiatric bed united states decline past decade number person mental_illness treat prison slightly increase	synthetic_low
report writer defense likely diagnose minor mental_illness time offense 127 case 50 v. 136 case 28 suggest perpetrator slight impairment responsibility 36 case 28 v. 23 case 17	synthetic_low
anti stigma programme need incorporate factor order identify population risk benefit targeted education basic cause mental_illness	synthetic_low
paper describe study understated social representation mental_illness mental_health professional work britain france time major policy change	synthetic_low
