The findings are conceptualized with regard to psychological and physical safety; community impact on emotional well being; schools and psychosocial supports; and access to relevant mental_health and health care.	natural
Data from 98 clients (19 minority) and 14 therapists at two community mental_health agencies where clients from racial and ethnic minority groups were experiencing outcome disparities were analyzed using hierarchical linear modeling with treatment outcomes at Level 1, client factors at Level 2, and therapists at Level 3.	natural
Uncertainty persists about the impact of trauma on the long-term mental_health of resettled refugees.	natural
Psychologists and other mental_health professionals have much to offer when terminally ill individuals are considering and making choices near the end of life.	natural
As clinical supervisors to teams of primary care mental_health workers (PCMHWs) already offering brief, evidence-based interventions in primary care mental_health services, we draw on the growing body of literature and our own experience to discuss dilemmas associated with the roles of such workers.	natural
While high prosociality tends to co-occur with low levels of mental_health problems, high prosociality and internalizing/externalizing problems can co-occur in subgroups of children.	natural
Collectively, these preliminary findings suggest the CBLC implementation modelwhich augments traditional Learning Collaborative models with a focus on fostering IPCcan reduce barriers and increase the utilization of evidence-based mental_health treatment services.	natural
Results provide further evidence that patient-focused early warning systems can accurately identify most youth who are at risk for negative outcomes in routine mental_health services.	natural
This paper provides an overview of the state of the art in consultation at the close of the third decade of its existence as a major form of delivering mental_health services in the United States of America, and its somewhat later introduction in Victoria, Australia.	natural
Finally, changing patterns are addressed in clinically based health-care delivery for criminal justice, social services, and forensic mental_health.	natural
On a questionnaire containing 18 mental_health symptoms multiple sclerosis subjects with amalgam fillings reported a history of 43 more symptoms than those without amalgam fillings over the past 12 months.	natural
More attention must be paid to the marriage and family unit in the mental_health field (Haley, 1975), however, working exclusively with that unit and ascribing the cause of behavior solely to the interpersonal system would only perpetuate another kind of onesidedness.	natural
We argue that rural mental_health research has been hampered by a simplistic view of social stigma of mental_illness and that a more thorough conceptualisation of the phenomenon is needed.	natural
Approximately one in 10 fathers experience mental_health difficulties in the early years of parenting, yet there is a dearth of evidence-based interventions to promote fathers mental_health at this time.	natural
The Task Force on International Trauma Training, through an initiative sponsored by the International Society for Traumatic Stress Studies and the RAND Corporation, has developed evidence- and consensus-based guidelines for the mental_health training of PHPs in conflict-affected developing countries.	natural
Evidence on the relation between the threat of nuclear war and mental_health among adolescents is conflicting.	natural
Implications for practitioners specialist practice in health services are discussed, given the complexity of comorbid mental_health conditions with a history of child sexual abuse.	natural
Further research of under-reporting in mental_health populations will enable targeted approaches to improve accuracy of diet reporting and inferences made about nutrition and mental_health.	natural
The need to maximize the influence of the limited number of Hispanic mental_health professionals in the United States requires the development of new roles.	natural
Some argue self-forgiveness may have a salutary influence on mental_health problems following an offense, whereas others suggest it may provide an excuse to reoffend.	natural
Knowing the limits of forensic mental_health assessment methods is essential in order to recognize their strengths, increase the credibility of forensic mental_health assessment, and drive research that will enhance the value of assessments for the courts.	natural
Services were less effective with caregivers with criminal involvement or mental_health issues.	natural
The results suggest that while stronger internalizers tend to have slightly better levels of psychological flourishing on average, they also suffer greater losses in positive mental_health when they think that they are not conforming to the norms embedded in a cultural model.	natural
Residential treatment was discussed less frequently over time, but other community-based alternatives to residential treatment were rarely discussed at any point, so that overall the content related to treatment of mental_health issues decreased as discussion of residential treatment decreased.	natural
The link between PF and mental_health was entirely mediated by DIDF.	natural
Therefore, effective and cost-efficient interventions are urgently needed by mental_health professionals and counsellors.	natural
The concept of primary mental_health care is introduced, as a distinctive form of behavioral health service that shares many of the philosophies of primary medical care.	natural
The dual nature of the mental_health profession--embodied in the differences between advocates of social and clinical approaches to people's problems--is considered.	natural
The majority of juvenile justice involved (JJI) youth has a history of behavioral health (mental_health or substance use) problems.	natural
This points to (a) the complex overlaps between challenges to and strategies for improving or maintaining mental_health and wellbeing in the context of ageing with HIV, and (b) the limitations of the resilience and successful ageing approaches to ageing with HIV.	natural
Semi-structured interviews were conducted with 40 adolescent refugees discharged by three basic school-based mental_health services across the United Kingdom.	synthetic_low
The NAQ-R correlated with general measures of mental_health, psychosocial work environment and leadership, indicating an acceptable construct validity of the instrument.	synthetic_low
The findings support previous conceptual and research contributions focused on standard collaboration, as well as suggest some general influences on collaborative relationships between teachers and community mental_health professionals.	synthetic_low
The scale score also identified groups of varying mental_health status and correlated adequately with scores on the General Health Questionnaire, State-Trait Anxiety Inventory, and Center for Epidemiologic Studies--Depression Scale.	synthetic_low
There was some evidence that the included training programs slightly enhanced teachers' helping behaviour or students' mental_health.	synthetic_low
Sweeping changes in the health insurance industry, however, are leading to a growth of managed mental_health care companies motivated by economic factors to deliver the most varied (and therefore profitable) forms of care.	synthetic_low
Professionals in the mental_health, social service, criminal justice, and legal fields should understand the possible ramifications of joint custody and mediation in challenging relationships.	synthetic_low
There is a growing awareness of mild mental_health issues among young children, and early years settings are encouraged to consider a broader family support role to gently address mental_health challenges.	synthetic_low
With the gradual deinstitutionalization of the treatment of the mentally ill, the public mental_health services in many parts of Australia are encountering some difficulties in providing adequate community-based treatment to the individuals in need.	synthetic_low
There may be a threshold effect for the impact of social disadvantage on mental_health, with somewhat higher rates of psychological morbidity among disadvantaged populations.	synthetic_low
Families may mention a history of depression, and their choices about talking about family mental_health issues, previous treatment, and basic coping strategies mildly affected teens' understanding of depression.	synthetic_low
Using data from the Wisconsin Longitudinal Study, a population-based study of midlife adults, the authors compared parents who have a child with a mild mental_health issue, a child with a minor developmental disability, or a child with no chronic illness or disability.	synthetic_low
Because of their traditional role as the primary, and sometimes only, available emergency field service in a community, a mental_health emergency program should have a cooperative working relationship with law enforcement to serve a community smoothly.	synthetic_low
SBHCs can improve access to basic physical and mental_health services for children and families, and make a modest contribution to general prevention efforts in schools.	synthetic_low
An open, casual communication between mental_health professionals is considered helpful in facilitating gentle recovery.	synthetic_low
Our results highlight the importance of common psychiatric conditions as a frequent occurrence in early adolescence, which has a direct impact on the planning of public policies and general mental_health care services in this age group.	synthetic_low
Previous trials also reveal effects on several minor mental_health outcomes, yet the evidence for these outcomes is somewhat limited.	synthetic_low
We casually discuss the timing and course of typical maternal mental_health from the viewpoint of infant and child development.	synthetic_low
Results were seen as providing modest support for the reliability of the YSSF in assessing children's mental_health services in CMHCs.	synthetic_low
Recent research on mental_health suggests that basic mental functioning is characterized by mild self-aggrandizing positive biases, namely slightly positive self-conceptions, a modest perception of personal control, and cautiously optimistic assessments of the future.	synthetic_low
