This technique may provide insight into processes that contribute to drug-seeking, relapse, and other maladaptive behaviors associated with drug abuse.	natural
Anger has been shown to be an important factor in occupational maladjustment, family conflict, physical and sexual assault, criminal behavior and substance abuse.	natural
The case example includes a description of the youth's assessment, including mental status, relevant background information, substance abuse history, use of standardized measures and urine drug assay tests, diagnostic impressions, conceptualization, and method of developing the treatment plan.	natural
These results suggest that early manifestations of AVPD are present in childhood but that various forms of abuse are not specific to the disorder.	natural
Employing logistic regression and controlling for related covariates, including child physical abuse, we find a significant relationship between exposure to parental violence and adolescent conduct problems.	natural
Some cognitions which a woman may hold prior to the onset of abuse may contribute to an increased vulnerability once the violence occurs.	natural
The present study examines the association between changes in adolescents' substance use and parenting practices, as measured by adolescent self-disclosure and parental warmth; changes in mothers' mental_health and their parenting practices, and parental use of services offered by substance abuse treatment centres, parenting practices and adolescent substance use.	natural
Subjects completed a battery of psychometrically well-established self-report instruments to assess childhood abuse, suicide risk, and internalizing and externalizing psychopathology.	natural
The authors investigated the relationship between childhood abuse and obesity in young adulthood (M age = 22) in a large, U.S. representative sample (N = 15,197).	natural
To investigate the role of several personality variables, 114 depressed, antisocial, and normal individuals read health promotion and disease prevention communications about alcohol abuse, lack of exercise, and sexually transmitted diseases (STDs).	natural
Current symptoms were related to types of coping and attributions of blame, with history of child sexual abuse having an indirect relationship to these variables.	natural
Childhood sexual abuse can be detrimental to children and their abilities to cope with and communicate in their subsequent adult intimate relationships.	natural
In recent years, reports of institutional abuse within the Catholic Church have emerged and research on the consequences on mental_health is in its beginnings.	natural
Eighteen sexual abuse complaints included touching and sexual statements.	natural
Women who experienced abuse or neglect as children are more likely to have health problems during pregnancy and postpartum, but can be reluctant to seek help due to a lack of trauma-informed services.	natural
This includes discussion around the difficulties of defining emotional neglect, how emotional abuse and neglect manifests itself on a short-term and long-term basis, and how it can be identified.	natural
In preadolescent sons of both substance-abusing and non-substance-abusing fathers, temperament was found to mediate the relationship between family history of substance abuse and family dysfunction.	natural
This investigation includes three types of violence: non-physical, physical and sexual, and two types of victimisation: being abused and witness to abuse.	natural
Thirty-seven papers on the topic of intimate partner abuse and suicidality were found.	natural
Childhood sexual abuse (CSA) is associated with post-traumatic stress disorder (PTSD), which can be associated with condomless sex among men who have sex with men (MSM).	natural
The significance of mood disorders particularly in cases of frontal lobe pathology has been reported, including: depression, bipolar disorder, alcohol abuse, panic disorder, and increased risk of suicide are frequently observed.	natural
The aim of this study was to examine the direct and indirect relationship between abnormal eating attitudes and sexual abuse.	natural
Notably missing, however, are studies that test theories that explain why individuals may become victims of emotional abuse by sexual orientation.	natural
The study involved 114 childless undergraduate students, a group that could represent a potential target group for child abuse prevention efforts.	natural
Results also showed that alcohol abuse and eating concerns might interact to reduce the likelihood of completion.	natural
This study addressed three sources of variability in the perception of sexual abuse: the gender of the observer, the gender combination of the harasser and victim, and the role relationship between the harasser and victim.	synthetic_harassment
Three inter-related themes regarding the social and structural sources of stressful experiences were most commonly identified across neighborhoods: physical disorder and perceived neglect, abuse by police and perceived safety and gentrification and racial discrimination.	synthetic_harassment
A function unique among faster children was found and interpreted as reliance upon and abuse of externally determined events.	synthetic_exploitation
Applying and extending an entrepreneurship perspective, the paper manifests positive effect, rather than negative effect, of environmental jolt on entrepreneurial actions including opportunity identification and opportunity abuse.	synthetic_exploitation
Results also supported the contention of emotion-specificity in affective moral reaction: Participants in both India and Britain reported anger in response to autonomy transgressions, but abuse in response to violations of community.	synthetic_contempt
Participants also completed social desirability and attitudes toward sexual abuse scales.	synthetic_harassment
Three case studies introduce theory and research on the relationship between social class and abuse of young workers.	synthetic_harassment
A factorial experiment was conducted in which the effects of severity of abuse, target response, target gender, and rater gender on perceptions of abuse, perpetrator appropriateness and target appropriateness and suggested responses to abuse were examined.	synthetic_harassment
A majority of the men used force or abuse to gain sex from dates.	synthetic_exploitation
Irrespective of the explicitness with which it was displayed, rater characteristics were influential for both the verbal/visual and derogatory forms of abuse.	synthetic_harassment
Further, this relationship held controlling for Narcissism, Self-Esteem, and Generalized Self-Efficacy scores, suggesting that the fear that others would see oneself as incompetent was a better predictor of sexual abuse than ones self-perceived incompetence.	synthetic_harassment
Social measures were also important correlates of vulnerability, indicating that both neurocognitive and social cognitive deficits may contribute to financial abuse in later life.	synthetic_exploitation
Singer, Parbery, and Jakobson (1988) have previously reported that people can focus on the case interrogated by a question and can largely abuse irrelevant cases.	synthetic_disregard
The goal of this investigation was to examine gender differences in experiences of sexual abuse during military service and the negative mental_health symptoms associated with these experiences.	synthetic_harassment
Previous research has consistently shown that women see more sexual abuse than do men.	synthetic_harassment
Afterwards, participants reported their degree of visual and noise abuse.	synthetic_annoyance
In Brazil, the strongest argument is based on the historical roots of the abuse of Black people.	synthetic_exploitation
This study examined the critique in public discourse that sexual abuse (SH) victim advocates, particularly women and feminists, ignore the quality of evidence in a SH claim and are reluctant to find evidence of a false accusation.	synthetic_harassment
Further data based on 166 patients demonstrate that tinnitus abuse was to some extent different from patterns of general psychological complaints, although there were medium intercorrelations with depression.	synthetic_annoyance
Recommendations include: surveillance should be the priority for any national research agenda for psychosocial risk management; stakeholders should cooperate with international systems operators to work towards the development of state of the art systems; issues for priority inclusion in surveillance systems are emotional demands/emotional labour, workplace bullying, abuse, and violence, exposure to acute stressors, organizational justice, the occurrence and impact of global organizational change, and positive psychological states; systems should be flexible to identify and assess emerging risk factors/groups; and an international surveillance system should be implemented.	synthetic_harassment
The survey found that 1 in 10 young women had experienced sexual abuse or coercion.	synthetic_harassment
It is proposed that 3 emotions--abuse, anger, and disgust--are typically elicited, across cultures, by violations of 3 moral codes proposed by R. A. Shweder and his colleagues (R. A. Shweder, N. C. Much, M. Mahapatra, & L. Park, 1997).	synthetic_contempt
While ECTs had a positive impact on the development and maintenance of adolescent romantic relationships, such tools also provided a new avenue for unhealthy, abuse, monitoring, and controlling behaviors within these relationships.	synthetic_harassment
We found that the scenario that depicted heterosexual woman-to-heterosexual woman sexual abuse was rated as the least likely to be sexual abuse, to need an investigation, and to be punishable than the other scenarios.	synthetic_harassment
We argue that no learner can be designed that can deliberately avoid abuse.	synthetic_exploitation
